aba - अब adv. nun, jetzt, von nun an 
abaddha - आबद्द  n./adj. Bindung, gebunden 
abela - अबेला  n./adj. VerspaÃàtung, spaÃàt 
aber - अबेर  adj. spaÃàt 
aber bhayo - comp. es ist spaÃàt
abhas - n. Schimmer, Schatten, schwache Erinnerung, dunkle Erinnerung
abhav - n. Abwesenheit, Fehlen, Nichtvorhandensein
abhaya - n. Mangel an Furcht
abhibhavak - n. WaÃàrter, HuÃàter
abhilekh - n. Inschrift
abhinaya - n. Nachahmen, Imitation 
abhiprerit - adj. motiviert
abhipret - adj. beabsichtigt, geplant
abhiram -  adj. aÃàu√üerst schoÃàn
abhiruci - n. Neigung, Geschmack, Bestreben, Wunsch
abhivriddhi - n. Entwicklung, Fortschritt
abhiyan - n. Expedition, Marsch, Erforschung
abhiyukta - adj. beschuldigt,angeklagt
abhiyog - . Anklage, Beschuldigung
abhyas - n. Praxis
abrak - n. Glimmer
achamma - n. UÃàberraschung
acamma lagnu - v.i. uÃàberrascht sein, erstaunt,
acamma parnu - v.t. uÃàberraschen, verbluÃàffen, in Erstaunen versetzen
achanak -  adv. ploÃàtzlich, abrupt, unerwartet
achano - n. Brett zum Schneiden von Fleisch
achar - n. EingepoÃàkeltes (scharf und sauer), Chutney, Salsa
aachar - n. Verhalten
acaran - n. Verhalten
ackshar - n. Buchstabe, Alphabet, Silbe
achel - adv. heutzutage
achut - adj. unberuÃàhrbar, von niederster Kaste
achuti - n. UnberuÃàhrbarer, Niedrigkastiker
achutoddhar - n. Reformierung der UnberuÃàhrbaren
aad  - n. StuÃàtze, UnterstuÃàtzung 
adalat - n. Gericht, Gerichtshof
adambar - n. Angabe, Prahlerei, Protzerei
adanpradan - n. das Geben und Nehmen, Austausch, soziale Kommunikation
adarniya - adj. Respekt bezeugend, ehrerbietig
adarniya sadasya - n. Ehrenmitglied
adarsh - n. Ideal, Wert
adarvaci - adj. hoÃàflich
adaunu - v.t. anhalten, stoppen
adda - n. Amt, AmtsgebaÃàude, BuÃàro;Gericht
adesh - n. Befehl, Anordnung, Aufforderung
adha -  adj. halb
adhaibaje - adv. halb drei [Uhrzeit]
adhaini - n. die aÃàlteste Frau in einem Palastharem
adham - adj. gemein, schaÃàndlich, abscheulich, schaÃàbig, niedertraÃàchtig
adhar - n. Grundlage, Basis
adharit - n. Mitternacht
adharbhut - adj. grundlegend, fundamental 
adharit - adj. basierend auf beruht auf
adharit cha -  basiert auf
adharma - n. SuÃàndhaftigkeit, AreligiositaÃàt
adhi - adj. fast halb
adhikar - n. Recht, AutoritaÃàt, Besitztum 
adhikari - n. AutoritaÃàtsperson, Magistrat,Beamter 
adhikrit -  adj. autorisiert
adhiraj - n. SouveraÃàn, Oberherrscher, Oberherr
adhirajkumar - n. Prinz
adhirajya - n. SouveraÃànitaÃàt, Reich, Empire, KoÃànigreich
adhiveshan - n. Sitzung,Treffen,Session 
adhogati - n. Fall, Verfall, Niedergang 
adhunik - adj. neu, modern
adhyaksha - n. Chef, Direktor, Leiter,Vorsitzender
adhyay - n. Kapitel, Abteilung, Teil
adhyaan - n. Studie, Untersuchung, Studium, Lernen
aadi - n./adj. Anfang, Beginn, Ursprung, anfaÃànglich, erster; undsoweiter, usw.
adijati - n. Stamm
adikal - n. Urzeit
adikaran - n. Urgrund, Grundursache, Hauptursache, Hauptgrund
adikavi - n. erster Dichter, Urdichter 
adikavya - n. erstes Epos, Ramayana 
addinu - v.i. anhalten, stoppen
aaitavar - n. Sonntag
adivasi - n. Eingeborener, Ureinwohner
adkalnu - v.t. annehmen, vermuten, schaÃàtzen
adkanu - v.i. feststecken, gestoppt sein, angehalten sein
adkaunu - v.t. zum Stecken bringen
addinu - v.i. anhalten, stoppen, aufhoÃàren sich zu bewegen
aaduwa - adn. Ingwer
additiya - adj. unvergleichlich, einmalig, nie dagewesen
agadh - adj. unergruÃàndlich, tief, bodenlos 
agadi - postp. vor
agadi badhaunu - v.t. voranfuÃàhren, voranbringen 
agadi badhnu - v.i. voranschreiten, vorruÃàcken 
agalbagal- adv. von links bis rechts, auf beiden Seiten
aagami - adj. kommend, bevorstehend
agati - n. Mangel an Fortschritt, Verfall
Agena - n. Feuerstelle, Herd
Aago- n. Feuerstelle
aagat - n. Angriff, Anschlag, Attacke
aagami - adv. naÃàchstes Jahr 
aagaunu - v.i. satt sein
aginai - schon, vorher, fruÃàher, vor
agi lagnu - v.t. vorangehen, als erster gehen, fuÃàhren, anfuÃàhren
agi nai - adv. bereits, schon lange v.i. vorangehen
agi agi - vor langer Zeit, einstmals 
agillo - adj. erster, vorderster, fruÃàherer
agiltira - adv. vor
agipachi - ein andermal, bei anderer Gelegenheit, vorher, generell, gewoÃàhnlicheiner nach dem anderen
agisamma - adv. bis gerade, bis vor kurzem adj. hoch, gro√ü, stattlich
aglo - n. Riegel, Schlo√ü
agni - n. Feuer
agnikanda -  n. Feuersbrunst, Gro√übrand 
aago -  n. Feuer 
aagraha - n. Verlangen, Streben, Ziel     ********* sort it out alpthabetical *********
agulto -  n. brennendes HolzstuÃàck
aguwa -  n./adv. FuÃàhrer, fuÃàhrend
aagya - n. Befehl, Anordnung          ************* sor it 
aagyakari - adj. gehorsam, folgsam, ergeben
aahar - n. Nahrung, DiaÃàt
aahara - n. Nahrung, DiaÃàt
aahat - adj. geschlagen
aaimai -  n. Frau
aggyan - n./adj. Unwissenheit, Unkenntnis, Ignoranz; unwissend, ignorant
aggyaat - adj. unbekannt, geheim, verborgen, obskur
ahaan - int. nein
ahangkar - n. Arroganz, UÃàberheblichkeit, Eingebildetheit
ahile - adv. nun, jetzt, in diesem Augenblick
ain - n. Gesetz, Gesetzeskodex
aina - n. Spiegel, Glasscheibe
ainchetana - adj. au√üerKontrolle,kontrolliert von aÃàu√üeren KraÃàften
aiselu -  n. gelbe Himbeere
aaipugnu - v.i. ankommen
aaitabar - n. Sonntag
aitihasik - adj. historisch
aaja - adv. heute
aaja bihana - comp. heute morgen
aajkal - adv. heutzutage
aajabholi - adv. heutzutage
anjan - adj. unkundig, unwissend, ungebildet, irgnorant
ajang - adj. sehr gro√ü, riesig, enorm, betraÃàchtlich
ajat - adj. kastenlos, geaÃàchtet, von niederer Kaste, ungeboren
ajatsatru - adj. feindlos, ohne Feind
ajha - adv. noch, mehr noch, vielmehr conj. selbst dann, selbst jetzt 
aajivan - adj. lebenslaÃànglich
ajhai - n. Bestehen, beharren, HartnaÃàckigkeit
akad - adj. hartnaÃàckig, starrsinnig, stur
akkal - Wissen, Klugheit, Verstand 
akalpaniya - adj. undenkbar, unvorstellbar
akmakaunu - v.i. zoÃàgern, zaudern, innehalten 
akamakka - adj. verwirrt, erstaunt
akamakka parnu - v.t. verwirrt sein
akangksha - n. Bestrebung, Trachten,Sehnen
akanksha - n. Wunsch,Verlangen
akantak - adj. problemlos, ungehindert
akapat - adj. schuldlos, unschuldig, frei, offen
aakar - n. Form, Format, GroÃà√üe
akaraniya - adj. ungeeignet, unpassend
akarma - n. uÃàberfluÃàssige Tat, schlechte Tat
akarmak - adj. intranisitiv [grammatisch]
akarmanya - adj. uÃàberfluÃàssig,nutzlos
akarmi - n. Tunichtgut, UÃàbertaÃàter, SuÃànder, Schurke, Schuft taub, gehoÃàrlos, offizieller Bericht, Dokument
akarna - n. offizieller Bericht, Dokument
aakarsan - n. Anziehungskraft 
akartavya - adj. ungeeignet  
akartha - adj. grundlos, ohne Veranlassung, vergeblich 
aakash - n. Himmel, Firmament
aakashe taramarg - n. Seilbahn
aakashvani - n. RadiouÃàbertragung 
akasmat - adv. ploÃàtzlich, zufaÃàllig, unerwartet
akasmik - adj. unerwartet, ploÃàtzlich
akathaniya - adj. unbeschreiblich, obszoÃàn 
akathya - adj. unbeschreiblich, obszoÃàn
akavat - n. Pflicht, Gott
akbar - n. Name des dritten indischen Moghul-Herrschers
akbare - adj. extrem scharf, aÃàu√üerst scharf
akbari - adj. bezogen auf Akbar, rein, unverfaÃàlscht
akelo - adj. allein
akhabar -n. Zeitung
akhir - adv. endlich, schlie√ülich
akkal - n. Wissen, Klugheit, Verstand 
akkali - adj. Klug, weise, schlau,intelligent 
akkase - adj. himmelblau
akkasinu - v.i. hochfliegen
aakraman - n. Angriff, Attacke, Invasion 
akrista - adj. angezogen
akriti - n. Form, Format, GroÃà√üe 
aksar - adv. oft, haÃàufig, gewoÃàhnlich, viele, eine Menge
akshansh - n. Breite [geographisch]
akshar - n. Buchstabe, Alphabet, Silbe n. Sauerstoff
alag - getrennt, unterschiedlich 
alagyaunu - v.t. schlie√üen, befestigen,zuziehen [eine TuÃàr] 
alaichi - n. Kardamom
alangkar - n. VerschoÃànerung, AusschmuÃàckung
alasya - n. Faulheit, TraÃàgheit, UntaÃàtigkeit, MuÃà√üiggang
alchi - adj. faul, traÃàge
aalekh - n. Schreiben, Schrift, etwas Geschriebenes
algyaunu - v.t. aufheben, erheben, freisetzen, befreien
alhad - n. VergnuÃàgen, Freude, ErfuÃàllung

ali -  adj. etwas, ein wenig 
ali - n. Feldrain (an Terrassenfeldern)
alikati -  adj. ein wenig, eine kleine Menge
alilo - adj. salzarm, geschmacklos 
aljhanu - v.i. gefangen sein in
aljaunu - v.t. verwickeln, verwirren 
alkatra -  n. Asphalt
allare - n. Herumtreiber, Vagabund 
almalaunu - v.t. verwirren
almalinu - v.i. verbluÃàfft sein, verdutzt sein
almari -  n. Regal, Schrank
alochana - n. Kritik
alochanatmak - adj. kritisch
alok - n. Erleuchtung, Helligkeit, Licht
alpamat -  n. MinoritaÃàt, Minderheit
alsi - adj. faul, traÃàge
alu - n. Kartoffel
alu tachnu - v.t. Kartoffeln schaÃàlen
alubakhada - n. Pflaumenbaum
aam - adj. allgemein, generell 
ama - n. Mutter 
amai - n. Gro√ümutter
amaju - n. aÃàltere Schwester des Ehemanns
amala -  n. eine Obstart [suÃà√ü-sauer]
amanav - adj. unmenschlich, inhuman
amanya - adj. nicht akzeptiert, nicht befolgt
amar - adj. unsterblich
amarkosh - n. (ein Sanskrit-WoÃàrterbuch, verfa√üt von Amar Singh)
amba - n. Guave
amdani - n. Einkommen
amdanibadhaune - n. Einkommensentwicklung, Einkommenserzeugung 
amilo - adj. sauer
amir - adj. wohlhabend, reich
amiri - adj. wohlhabend, reich
amkhora - n. TrinkgefaÃà√ü aus Messing
aamnirvachan -  n. allgemeine Wahlen
amol -  adj. unbezahlbar, unschaÃàtzbar 
amrit - n./adj. Elixir, Nektar; unsterblich 
amulya -  adj. unbezahlbar, unschaÃàtzbar 
amurta - adj. formlos
an - int. ja  
anadarvachi -  adj. nicht-hoÃàflich [grammatisch] 
anadi  - adj. anfangslos,selbstgeschaffen
analamaya - adj. feurig, gluÃàhend, brennend
anand  - n. GluÃàck, GluÃàckseligkeit
anandi - adj. gluÃàcklich
ananta  - adj. endlos, infinit
anar - n. Granatapfel
anarsa - n. ein suÃà√ües Brot aus Reismehl, Zucker und Butter
anashan - n. Fasten, Hungern
anatha - adj. verwaist, unversorgt
anautha - adj. ungewoÃàhnlich, au√üergewoÃàhnlich, eigenartig, seltsam, komisch
anautho  - adj. ungewoÃàhnlich, au√üergewoÃàhnlich, eigenartig, seltsam, komisch, fremd
anaitikta - n. Unmoral
anavarat - adj. unaufhoÃàrlich, bestaÃàndig, konstant
anbhaunu - v.t. das Hochzeitspaar verabschieden, dem Hochzeitspaar Aufwiedersehen sagen
anchal -  n. Zone
ancal adalat - n. Zonengerichtshof 
ancal nyayadhish - n. Zonenrichter
ancal prashasan - n. Zonenverwaltung
ancal sabha - n. Zonenversammlung 
anchaladhish - n. Zonenkommissar
anchetnu -  v.t. disziplinieren, beeindrucken, draÃàngen
anda -  n. Ei
andaji - adv. annaÃàhernd, etwa, ungefaÃàhr
anderi -  n. RizinusoÃàlpflanze
andha - adj. blind
andhabhakta - n. bliner AnhaÃànger, Fanatiker, aberglaÃàubige Person
andhakar -  n. Dunkelheit
andheri - adj. dunkel, duÃàster
aandhi - n. Sturm, starker Wind
andhiyar - n. Teilhaber von der HaÃàlfte des Landes oder der Ernte 
andhopan - n. Blindheit
andhyaro - n./adj. dunkel, duÃàster, finster, traurig, Dunkelheit, Unwissenheit
andolan - n. Agitation, Unruhe, Bewegung
andra - n. Eingeweide
anduva - n. ein nicht-kastriertes Tier 
aneka - adj. diverse, verschiedene, viele
ang -  n. KoÃàrper, KoÃàrperteil, Glied, Teil 
anga pugnu - zu Ende kommen
anga-bhanga - n. VerstuÃàmmelung
anga-bhanga garnu - v.t. amputieren, verstuÃàmmeln
angacched -  n. Amputation
angalnu - v.t. annehmen, adoptieren
angalo - n. Umarmung, Armvoll
angan - n. Hof, Innenhof, Haus, Heim 
angar - n. Asche, Schlacke, Glut
anga-raksha - n. KoÃàrperschutz
anga-rakshak - n. LeibwaÃàchter
angethi - n. tragbare Feuerstelle, Eisen- oder TongefaÃà√ü zum Transport von Feuer
anggur - n. Traube
angikar - n. Akzeptanz, Annahme
angikar garnu - v.t. annehmen, akzeptieren, folgen
angikrit - adj. angenommen, zugestimmt, versprochen, zugesagt
angikrit nagarikta - n. angenommene StaatsbuÃàrgerschaft
angikrit nepali nagarikta - n. angenommene nepalische StaatsbuÃàrgerschaft
anginti - adj. zahllos, unzaÃàhlig
angka - n. Zahl, Ziffer, Ausgabe [bei Periodika], PruÃàfungsnote, Punktzahl [beim Spiel, Akt [in einem Drama]
angka ra akshar - n. Zahl und Buchstabe
angka ra aksharle bolaunu - in Zahlen und Buchstaben benennen
angka-ganit - n. Arithmetik, Mathematik 
angkamal - n. Umarmung
angkapatra - n. Etikett, Label, Band
angkit - adj. hervorragend, ausgezeichnet,nachgewiesen, erwiesen 
angkuran - n. Keimen,Anfang
angocha - n. Handtuch, Mundtuch, Serviette
angrej - n. EnglaÃànder, Westler
angreji - n./adj. englisch, britisch, Englisch 
angsha - n. Anteil, Teil, Bestandteil
angshadan - n. Beitrag
angshadhar - n. AktionaÃàr, Teilhaber, Erbe 
angsha ko hak - n. Erbe,Anrechtam vaÃàterlichen Besitz
angishiyar - n. Miterbe,Teilhaber,Partner
angul - n. Finger, Fingerbreit
anguli mudra -  n. Fingerabdruck
angulipratimudra - n. Fingerabdruck
angur - n. Traube
ani - conj. und, dann, und dann
anicchit - adj. unerwuÃànscht, unverlangt
anikal - n. Hungersnot
anil - n. Wind
anivarya -  adj. unvermeidlich
anjali - n. zusammengefaltete HaÃànde, Handvoll
anjuli -  n. zusammengefalteteHaÃànde, Handvoll
anka - n. Zahl, Ziffer, Ausgabe [bei Periodika], PruÃàfungsnote, Punktzahl [beim Spiel, Akt [in einem Drama]
ankai - n. SchaÃàtzung, Bewertung
ankanaunu - v.i. zoÃàgern, zaudern, unschluÃàssig sein
ankha -n. Auge
ankhako nani- n. Pupille
ankhibhuin - n. Augenbraue
ankuro - n. Spro√ü, SchoÃà√üling, Knospe
ankush -  n. Haken
anmaunu - v.t. das Hochzeitspaar verabschieden, dem Hochzeitspaar Aufwiedersehen sagen
anna - n. Getreide
anna-bhandar - n. Getreidesilo
aanp - n. Mango
anpadh - adj. ungebildet, unwissend,analphabetisch
anshu - n. TraÃàne
aant - n. Mut, KuÃàhnheit
aanta - n. Weizenmehl
anta - n. Ende, Abschlu√ü
anta garnu - v.t. ein Ende setzen, beenden
antai - adv. sonstwo
antar - n./adj. Unterschied, Intervall; inner, inter-
antaral rajya - n. Pufferstaat
antardeshiya - adj. inlaÃàndisch
antardeshiya jalpath -  n. inlaÃàndische Wasserwege
antardeshiya patra -  - n. Inlandsbrief
antardeshiya vanijya - n. Binnenhandel, Inlandhandel 
antardhvans - n. Sabotage
antargat - adj. einschlie√ülich
antargrasta - adj. verwickelt, involviert
antarik - adj. innerer
antariksha -  n. All, Weltall, Weltraum
antarmukhi - adj. introvertiert, nach innen gerichtet
antarrastriya -  adj. international
antarrastriya kanun - n. internationales Recht
antarrastriya mudrakos - n. WeltwaÃàhrungsfond
antarvarta - n. Interview,persoÃànliches GespraÃàch
antarvasan - n. Internierung,Verhaftung 
antarvasi - n. Internierter,Verhafteter
antarvasit -  adj. verhaftet,interniert
antarvasit garnu -  v.t. verhaften, internieren
antarvirodh - n. Selbstwiderspruch, innerer Widerspruch
antastha desh - n. Pufferstaat
anthanabbe - num. achtundneunzig, 98 
anthaunna - num. achtundfuÃànfzig, 58 
anthyaunu - v.t. ergreifen, fassen
anti - n. Ultimatum
antim - adj. letzt, endguÃàltig, letzte, letzter
antnu -  v.i. wagen, sich erkuÃàhnen
antya - n./adj. schlie√ülich, letztlich, Ende 
antyesti -  n. Totenzeremonie
anubhav - n. Erfahrung, Empfindung, Wahrnehmung, GefuÃàhl 
anubhavi - adj. erfahrung, empfunden,

anubhuti - n. Erfahrung, Erkenntnis, Empfindung
anudan - n. Subvention
anugaman - n. Nachfolger, Nachfolgerin
anuhar -  n. Gesicht,Antlitz
anukramnika - n. Inhaltsverzeichnis, Index
anukul - adj. guÃànstig, vorteilhaft, geeignet
anuman  - n. Schlu√üfolgerung, Annahme, Vermutung
anumati - n. Erlaubnis, Genehmigung, Zustimmung
anupasthit - adj. abwesend
anupras - n. Stabreim,Alliteration
anurodh -  n. Bitte,Wunsch,Ersuchen, Gesuch
anurodhgarnu - v.t. bitten ÃÅ
anurup  - adj. entsprechend, analog, kongruent, aÃàhnlich
anusandhan -  n. Untersuchung, Forschung 
anusar -  postp. gemaÃà√ü, entsprechend
anusaran - n. Einwilligung, Befolgung, UÃàbereinstimmung
anushasan  - n. Schulung,Erziehung, Anweisung  
anuvad - n. UÃàbertragung, UÃàbersetzung, Nachahmung, Immitation
anuvadak -  n. UÃàbersetzer
anuvar - n. Gesicht, Antlitz
anveshan - n. Erforschung, Erkundung, Sondierung, Untersuchung
anya - adj. andere, anderer
anyatra -  adj. sonstwo, woanders
anyaya  - n. Ungerechtigkeit, Unrecht
apachya - adj. unverdaut, unverdaubar   

apaharan - n. EntfuÃàhrung
apanaunu - ÃÅv.t. uÃàbernehmen, adoptieren, anwenden
aparadh -  n. Verbrechen, Vergehen, Fehler, SuÃànde
aparadhi -  n./adj. kriminell, Krimineller, Verbrecher
aparichit - adj. unbekannt, unvertraut
aparjhat - adv. ploÃàtzlich, uÃàberraschend, auf einmal
apas - n. Nahestehende, Verwandte
apasoch - n. Bedauern
apasma - adj. untereinander, unter sich
afai - adv. selbst, persoÃànlich
aphisar - n. Beamter, Polizeibeamter
aphno - adj. eigen
aphnu - adj. eigen
apil - n. Widerspruch, Einspruch, Berufung
aprakashit - adj. unveroÃàffentlicht
apratyashik - adj. unerwartet,ploÃàtzlich
apravasi - n. Einwanderer, Zuwanderer, Immigrant
apsara - n. Nymphe, Fee, Elfe
apurva - adj. neu, fremd
arab - num. Milliarde, 1.00.00.00.000 
arajakta - n. Anarchie
arakshan - n. Reservierung
aram - n. Ruhe, Erholung
aramba - n. Anfang, Beginn (Markierung einer indirekten Rede)
arini - adj. schuldenfrei
artha - n. Finanzen, Bedeutung, ErklaÃàrung 
arthadanda - n. Geldstrafe
artha-mantri - n. Finanzminister
arthashastra - n. Wirtschaft,Volkswirtschaft 
arthat - adv. n√§mlich, das hei√üt
arthik - adj. wirtschaftlich, finanziell
arit - n. Rat, Unterweisung, instruktion, moralische Lehre
aru - n. Pfirsisch
aru - adj. anderer, weiterer, mehr
aru kohi - irgendjemand anders, irgendein anderer
arubakhada - n. Pflaume
asabhya - adj. unzivilisiert, unkultiviert
asadh - n. Dritter Monat des nepalischen Kalenders (juni-juli)
asadharan - adj. ungew√∂hnlich, au√üergew√∂hnlich
asadya - adj. sehr, extrem
asahamati - n. Uneinigkeit, Dissens
asahaya - adj. hilflos
asal - adj. wirklich, wahr, gut, moralisch gut
asali - adj. echt, wirklich
asam - n. Assam 
asaman - n. Himmel
asamanta - n. Ungleichheit
asamayik - adj. unzeitgem√§√ü, unpassend, ungelegen
asamaya - n. Unzeit, falscher oder verfr√ºhter Zeitpunkt
asambhava - adj. unm√∂glich
asan - n. Sitz, Amt, Posten
asanggati - n. lrrelevanz, Adsurdit√§t, lrrationalit√§t, anomalie
asankhya - adj. zahllos, unz√§hlig
asanna - adj. nahe, eng
asantusta - adj. unzufrieden
asantusti - n. Unzufriedenheit
asapas - adv. in der n√§he
asaphal - adj. erfolglos, unerfolgreich
asar - n. Monat des nepalischen kalenders 	(juni-juli)
asar - n. Wirkung, Auswirkung, Einflu√ü, Autorit√§t
asat - adj. b√∂se, schlecht, nichtexistent, illusorisch
ash - n. Hoffung
asha - n. Hoffnung
ashangka - n. Verd√§chtigung, zweifel, furcht
ashanti - n. Mangel an frieen, unruhe
ashaya - n. Ziel, Zweck, intention, Veranlassung
ashcarya - n. Wunder, √ºberraschung, erstaunen
ashcaryalagdo - adj. √ºberraschend
ashiksha - n. Ungebildetheit, analphabetentum
ashikshit - adj. ungebildet, des lesens und schreibens unkundig, illiterat
ashirvacan - n. Segen
 ashirvacan - n. Segen ashirvacan - n. segen
 ashirvad - n. Segen
 ashis - n. Segen
 ashis dinu - v.t segen
 ashlil - adj indezent, vulg√§r, anst√∂√üig
 ashram - n.  Einsiedelei, wohnheim
 ashraya - n. Abh√§ngigkeit, zuflucht
 ashrit - postp. abh√§ngig von
 ashu - adj. shnell, rasch, geschwind
 ashuddha - adj. unrein
 ashutos - adj. zufrieden
 ashvin - n. Monat des nepalischen kalenders (september/oktober)
 asi - achtzig 80
 aassi - achtzig 80
 asima - adj. grenzenlos, unbegrenzt
 asimit - adj. grenzenlos, unbegrenzt
 asoj - n. Monat desnepalischen kalenders (september/oktober)
 aspast - adj. unklar, unbestimmt, vage
 aspastata - n. Unklarheit, verschwommenheit
 aspatal - n. Krankenhaus
 astaunu - v.i. untergehen (sonne)
 astha - n. Vertrauen, bewunderung, verehrung, glaube
 asthipanjar - n. Skelett, knochenger√ºst
 asti - adv. vorgestern, neulich
 astiko bihibar - vorigen donnerstag
 astitva - n. Existenz, das sein
 astrashastra - n. 
 astreliya - n. Australia
 asuvidha - n. Unbrauchbarkeit, ungeeigneteit
 asvabhavik - n. Adj. unnat√ºrlich
 asvasth - adj. ungesund
 asvikar - n. weigerung, zur√ºckweisung
 atah - conj. daher, folglich
 atainu - v.i passen zu, enthalten sein in
 atal - adj. unbeweglich, fest
 atangka - n. Furcht, schrecken, panik
 atangkit - adj. erschrocken, ver√§ngstigt
 ataunu - v.i. passen zu, enthalten sein in 
 atal - adj. unbeweglich, fest
 atanka - n. Furcht, schrecken, panik
 atangkit - adj. erschrocken, ver√§ngstigt
 ataunu - v.i. passen zu, enthalten sein in
 ateri - adj. eigensinnig, halsstarrig, hartn√§ckig
 ath - num. acth, 8
 athara - adj. achtezehn, 18
 athasi - adj. achtundachtzig, 88
 athaun - adj. achte, achter
 athava - adj. achtundvierzig, 48
 athhattar - adj. achtundsiebzig, 78
 athsatthi - adj. achtundsechzig, 68
 athtis - adj. achtunddrei√üig, 38
 ati - adj. sehr viel, √§u√üerst,au√üerordentlich
 atikraman - n. Verletzung, regelversto√ü
 atirikta - adv. extra, zus√§tzlich
 atit - n./adv. vergangenheit, vergangen, vor√ºber
 atithighar - n. G√§stehaus, resthaus
 atithishala - n. G√§sthaus, resthaus
 atma - n. Geist, seele, intellekt
 atmahatya - n. Selbstachtung, stolz
 atmanirbhar - n. Autarkie, autonomie
 atmasamman - n. Selbstrespkt, selbstachtung
 atmavibhorta - n. Faszination
 atmavishwas - n. Selbstvertrauen
 atripti - n. Uners√§ttlichkeit, mangel an befriedigung
 attalika - n. Balkon,veranda
 attar - n. Duft, wohlgeruch, aroma,
 atthais - n. Achtundzwanzig
 attinu - v.i. erschrocken sein, nerv√∂s sein
 atur - adj. krank, verwundet, ungeduldig
 atut - adj. ununterbrochen, fortgesetzt
 atut - adj. ununterbrochen, fortgesetzt
 atuva - n. Ingwer
 atyachar - n. Unterdr√ºckung, tyrannei
 atyanta - adj. viel, sehr viel, extrem, √§u√üerst
 atyavashyak - adj. sehr motwendig, essentiell
 atyuki - n. √úbertreibung
 au - n.Conj. und
 aucutya - n. Wert, nutzen
 audyogik - adj. industriell
 aunlo - n. Finger
 aunlyaunu - v.t. ziegen auf
 aunsi - n. Neumond, letzter tag der dunklen h√§lfte des mondkalenders
 aunu - v.i. kommen
 aupacharik - adj. formell, teremoniell
 aupachrik adarvaci - adj. formell-h√∂flich (sprachgebrauch)
 ausadhipasal - n. Apotheke, drogerie
 avadhi - n. Zeit, zeitraum, zeitspanne, periode
 avahela - n. Misachtung
 avaj - n. Stimme, klang, bericht
 avakash - n. Freizeit
 avalamban - n. Unterst√ºtzung, vertrauen
 avalokan - n. Blick, starren
 avanati - n. Verfall, niedergang
 avaroad - n. Hindernis, behinderung
 avas - n. Wohnung
 avasar - n. Chance, gelegenheit, augenblick, anla√ü
 avasar paunu - v.t. eine gelegenheit nutzen
 avashya - adv. gewi√ü, sicherlich
 avashyak - adj. obligatorisch, notwendig, n√ºtzlich unumg√§nglich
 avashyakta - n. Notwendigkeit, unvermeidbarkeit
 avastha - n. Situation, umstand, zustand, bedingung, lage
 avasyakta - n. Notwendigkeit, bedarf
 avat-javat - n. Das kommen und gehen, verbindung, √ºberschreitung, √ºberquerung
 avicchinna - adj. unaufh√∂rlich, ununterbrochen
 avikasit - adj. unentwickelt
 avishvas - n. Mi√ütrauen, vertrauensmangel
 aviskar - n. Entdeckung, erfindung
 avivekpurna - adj. grundlos, unbegr√ºndet
 avyavastha - n. Unordnung
 ayaram gayaram - n. H√§ufiger abweichler
 ayarlaind - n. Irland
 ayog - n. Kommission
 ayojana - n. Projekt
 ba - n. Vater (umgangssprachlich)
 babu - n. Vater
 bada - adj. gro√ü, riesig, gigantisch
 bada hakim - n. Distriktgouverneur, distriktbeamter (bis ende 1965)
 badal - n. Wolke
 badar - n. Affe
 badam - n. Erdnu√ü
 badamash - adj. unmoralisch, lasterhaft, schlecht, b√∂se
 badanam - adj. verleumdet, verrufen, ber√ºchtigt
 badha - n. Hindernis, hinderungsgrund
 badhak - adj. hinderlich, behindernd
 badharnu - v.t. fegen, kehren
 badhaunu - v.t. ausdehnen, ausweiten
 badhi - adj. mehr, mehr als n√∂tig, gr√∂√üer, h√∂her
 badhiya - adj. gut, sch√∂n, hervorragend, √ºberlegen, von guter qualit√§t
 badhnu - v.i. anwachsen, zunehmen, gr√∂√üer werden, sich entwickeln, aufbl√ºhen, wachsen, anwachsen
 badi - n. (die dunkle h√§lfte des mondmonats) schlechtigkeit, verwerflichkeit
 bado - adj. gro√ü, riesig, gigantisch
 bagaincha - n. Garten, obstgarten
 bagbani - n. Gartenbau
 baggi - n. Wagen, pferdewagen
 bagh - n. Tiger
 bagha - n. Hindernis
 bagnu - v.i. flie√üen, gleiten
 bagvani - n. Gartenbau
 bahadur - adj. tapfer, mutig
 bahas - n. Diskussion, argumentation, debatte
 bahattar - num. zweiundsiebzig, 72
 bahek - postp. au√üer, neben
 bahini - n. J√ºngere schwester
 bahinijvain - n. Ehemann der j√ºngeren schwester
 bahira - postp. au√üen, drau√üen
 bahira samet - sogar drau√üen, sogar au√üerhalb
 bahirapatti - adj. au√üenseite
 bahiro - adj. taub
 bahiskar - n. Ausschlu√ü, verweis, entfernung
 bahra - nim. zw√∂lfter, 12
 bahraun - adj. zw√∂lfter
 bahudaliya - adj. vielparteien
 bahudaliya vyavastha - n. Vielparteiensystem
 bahumat - n. Mehrheit, majorit√§t
 bahumulya - adj. wehrheit, majorit√§t
 bahumulya - adj. wertvoll, teuer, kostspielig
 bahun - n. Brahmane
 baijani - adj. violett
 baink - n. Bank, geldinsititut
 bais - num. zweiundzwanzig, 22
 baisatthi - num. zweiundsechzig, 62
 baishakh - n. Sitzung, treffen, session, wohnzimmer
 baj - n. Habicht 
 baje - uhr  (bei uhrzeiten)
 baje - n. Gro√üvater
 bajet - n. Budjet, etat
 bajhnu - v.i. zanken, sich streiten
 bajnu - v.i. klingen, t√∂nen, schlagen
 bajyai - n. Gro√ümutter
 bakas - kiste, koffer
 bakas - n. Geschenk, auszeichnung
 bakhat - n. Zeit, zeitpunkt, augenblick, period, gelegenheit
 bakhri - n. Ziege (weiblich)
 bakhro - n. Ziege
 bakkulo - n. Kranich
 baklo - adj. dick
 baksanu - v.t. schenken, geben, (als gehenk oder auszeichnung durch pers√∂nlichkeiten, z.B. durch den k√∂nig)
 bal - n. St√§rke, macht
 bal - n. Kind, junge
 balatkar - n. Vergewaltigung
 bali - adj. stark, m√§chtig, einflu√üreich
 bali - n. Stehende frucht, pflanze, ernte
 balika - n. Junges m√§dchen
 balistha - adj. stark, m√§chtig, einflu√üreich
 balkrishna sama - n. (ein bedeutender nepalischer dichter)
 balnu - v.i. angez√ºndet werden, aufeuchten, feuer fangen
 balnu - v.t. anz√ºnden, entfachen
 balti - n. Sch√ºssel, wanne
 balun - n. (eine art volkslied)
 balyakal - n. Kindheit
 bamojim - adv. entsprechend, gem√§√ü
 bamojit - adj. entsprechend 
 banaunu - v.t. machen, herstellen, produzieren
 bancharo - n. Axt
 bachnu - v.i. √ºberleben
 banda bhayo - comp. es ist zu, es ist geschlossen
 banda garnu - v.t. schlie√üen
 bandakopi -  n. Kohl, Kraut
 bandar -  n. Affe
 bandel - n. Wildschwein
 bandhan - n. Haft
 bandhnu - v.t. festigen, befestigen,binden
 bandi - n. Gefangener, Geisel, Verhaftung, Bestrafung, Inhaftierung
 bandhighar - n. Gef√§ngnis
 bandigriha - n. Gef√§ngnis
 bandikhana - n. Gef√§ngnis
 bandnu - v.t. teilen
 banel - n. Wildschwein
 bango - adj. krumm, gekr√ºmmt, gebogen
 bangur - n. Schwein
 bani - n. Verhalten, Charakter
 banki - n. Rest, √úberbleibsel, √ºberrest
 bannu - v.i fertig sein, gemacht sein
 bans - n. Bambus
 bansko parda - n. Bambusvorhang
 bar - n. Zaun, provisorische wand
 bar - n. Wochentag [des nepalischen Kalenders]
 bara - n. Urgro√üvater
 barbar - n./adj. Barbare, Wilder
 barbarta - n. Barbarei
 bare - postp. √ºber, in Bezug auf
 bari - n. Garten, Trockenfeld
 barkha - n. Regenzeit, Monsun
 barnu - v.t. beachten, sich enthaten von
 baru - vielmehr, andereseits, oder
 barulo - n. Wespe
 basai sarai - n. Migration, Wanderung
 basalnu - v.t. setzen, zum Sitzen veranlassen
 basaunu - n. Fr√ºhling, Fr√ºhjahr
 basaunu - v.t. setzen, zum Sitzen veranlassen
 basinda - n. Einwohner, Bewohner
 basnu - v.i. sitzen, wohnort
 basobas - n. Wohnplatz, Wohnort, Wohnung
 basovas - n. Wohnplatz, Wohnort, Wohnung
 bata - postp. von [her], durch [√∂rtl.]
 bata marnu - v.i. sich unterhalten, erz√§hlern, plaudern
 batas - n. Wind
 batho - adj. klug, schlau, intelligent
 bato - n. Stra√üe, Weg, pfad
 bato lagnu - v.t. sich auf den Weg machen
 battai - n. Wachtel
 batti - n. Lampe
 battis - num. zweiunddrei√üig, 32
 batuko - n. Sch√ºssel, Schale
 baulaha - adj. verr√ºckt
 baunna - num. zweiundf√ºnfzig, 52
 bayalis - num. zweiundvierzig, 42
 bayan - n. Beschreibung, Schilerung, Bericht
 bayan - adj. links, linke, linker
 bayanabbe - num. zweiundneunzig, 92
 bayasi - num. zweiundachtzig, 82
 becnu - v.t. verkaufen
 beglo - adj. getrennt, separat
 behornu - v.i. Ausschau halten nach, Gebrauch machen von
 bela - n. Zeit, Gelegenheit
 beluka - n./adj. Abend, am Abend, abends
 bemajja - adj. unerfreulich
 benci  - n. Bank [zum Sitzen]
 bensi - n. Senke, Niderung, Tal, Flachland
 bepar - n. Handel
 bepar garnu  - Handel treiben, verkaufen
 bepari - n. H√§ndler, Kaufmann
 ber - n. Zeit, Zeitdauer
 berojgar - n. Arbeitslosigkeit, Besch√§ftigungslosigkeit
 bes - adj. gut, sehr gut
 besar - n. Kurkuma, Gelbwurz
 besari - adv. reichlich, vollauf, vollends
 bevasta - adj. gleichg√ºltig, interesselos, unachtsam, uninteressiert
 bhada - n. Miete, Geb√ºhr, Leihgeb√ºhr, Fahrpreis
 bhadai - n. Tochter des Bruders einer Frau
 bhadau - n. f√ºnfter Monat des nepalischen kalenders [Augest-September]
 bhadgaun - n. Bhaktapur, Bhadgaon [Stadt im √∂stlichen Kathmandu]
 bhadkinu - v.i. sich f√ºrchten, Angst haben, sich scheuen
 bhado - n. Sohn des Bruders einer Frau
 bhadra - n. f√ºnfter Monat des nepalischen Kalenders [Augest-September]
 bhagun - v.i. fliehen, weglaufen, wegrennen, davonrennen j√ºngerer Bruder
 bhai- bharadar - n. offielle Anrede des K√∂nigs an seine k√∂niglichen verwandten
 bhaibuhari - n. Ehefrau des j√ºngeren Bruders
 bhain - n. Erde, Erdoboden, Erdoberfl√§che
 bhainsi - n. Wasserb√ºffel [weiblich]
 bhajan - n. Beh√§lter, Gef√§√ü,Objekt, Gegenstand
 bhaka - n. Versprechen
 bhakti - n.adj. Verehrer, fromm, verehrt
 bhaktipur - n. Bhaktipur, Bhadgaon [stadt im √∂stlichen Kathmandu]
 bhaki - n. Verehrung
bhaktiman - n.adj. Verehrer, fromm, verehrt
bhakundo khelnu - v.t. Fu√üball spielen
bhala - n. Speer, Lanze
bhalai - n. G√ºte, gute Tat
bhale mujur - n. Truthahn
bhalu - n. B√§r
bhanda - postp. im Vergleich zu, als [beim Komparativ]
bhandakunda  - n. T√∂pfe und Pfannen, Kochgeschirr
bhandaphor - n. Preisgabe, Enth√ºllung, Verrat
bhandar - n. Speicher, Lagerraum
bhandnu - v.t. ruinieren, zerst√∂ren, verderben
bhando - n. Kochtopf, Topf, Gef√§√ü
bhane - conj. wenn, andererseits
bhangero - n. Sperling, Spatz, Sperber
bhanij - n. Sohn der Schwester
bhanji buhari - n. Ehemann des Sohnes der Schwester
bhanje jvain - n. Ehemann der Tochter der Schwester
bhanji - n. Tochter der Schwester
bhanjo - n. Sohn der Schwester
bhanjyyang - n. Enges Tal, Pa√ü, Pa√ü√ºbergang, Gebirgspa√ü
bhanne - adj. genannt, namens
bhansa - n. K√ºche
bhansar - n. Zoll, Zollamt
bhanubhakta acarya - n. Bhanubhakta Acharya [ein bedeutender nepalischer Dichter]
bhar - n. Glaube, Vertrauen,Vollst√§ndigkeit
bhar parnu - v.t. vertrauen, Vertrauen schenken
bharadar - n. hoher Funktion√§r oder Beamter
bharadari sabha - n. Rat der Adligen, Satatsrat, die Versammlung der bharadar in der fr√ºhen Shah-und Rana- Zeit
bharat - n. Indien
bharatiya - adj. indisch
bhare - postp. nachher, sp√§ter
bhari - adj. schwer [an Gewicht]
bhari - adj. gef√ºllt [bis zum Rand], voll, randvoll, voller
bharibharau - adj. voll, √ºberf√ºllt
bharipurna - adj. voll, √ºberf√ºllt
bharkar - adv. k√ºrzlich, kurz zuvor, vor kurzem, soeben, gerade jetzt
bharopeli - adj. indoeur√∂p√§isch
bharopiya - adj. indoeur√∂p√§isch
bharosa - n. Hoffnung, Vertrauen
bhartsana - n. Vorwurf, Beschimpfung
bharya - n. Ehefrau, Gattin
bharyang - n. Treppe
bhasa - n. Sprache
bhasan - n. Rede, Ansprache, Vortrag
bhasan dinu - v.t. eine Rede halten, einen Vortag halten
bhasavigyan - n. Linguistik, Sprachwissenschaft, Philosophie
bhat - n. Reis [gekocht]
bhatamas - n. Soyabohne
bhatiji - n. Tochter des Bruders eines Mannes
bhatijo - n. Sohn des Bruders eines Mannes
bhattarak - adj. verehrt, respektiert
bhau - n. Preis, Wert, Rate
bhaugolik - adj. geographisch
bhaugolik mahatva - n. Geographische Bedeutung
bhauju - n. Ehefrau des √§lteren Bruders
bhava - n. Denken,Bewu√ütsein, Gedanke, Empfinden, Geisteshaltung
bhavan - n. Haus, Herrenhaus, Palast, Geb√§ude
bhavan nirman kala - Architektur
bhavana - n. Denken, Denkweise, Bewu√ütsein, Gedanke, Empfinden, Geisteshaltung
bhavavacak nam - n. Abstraktum, Begriffswort
bhavya - adj. riesig, pomp√∂s, prachtvoll
bhedo - n. Schaf
bhek - n. Nachbarschaft, Gebiet, Lokalit√§t
bhela - n. Versammlung (von Leuten)
bhet - n. Treffen, Begegnung, Interview
bhet hunu - v.t. √ºber den Weg laufen, treffen, begegnen
bhetnu - v.i./v.t. treffen,begegnen, sich treffen, herausfinden
bhijnu - v.i. na√ü werden
bhiksha - n. Almosen, mildt√§tige Gabe
bhinaju - n. Ehemann der √§lteren Schwester
bhinnata - n. Unterschied
bhitra - postp. in, drinnen
bhitrinu - v.i. betreten
bhitriya - adj. als Familienmitglied gerechnet
bhitte - Wand, Innenwand
bhitto - n. Wandseit
bhogate - n. Grapefruit
bhogdan - n. Hilfe, Beistand
bhojan - n. Speise, Nahrung, Essen
bhojnalaya - n. K√ºche, Caf√©, Kantine, E√üzimmer
bhok - n. Hunger
bhok lagnu - hungrig sein, Hunger haben
bhokaunu - v.i. hungrig sein, Hunger haben
bholi - adv. morgen
bhote - n. Bhote, Tibeter
bharaman - Reise
bhrasta - adj. gefallen, verschmutzt, verunreinigt
bhrastacar - n. Korruption, korrupte, Praxis
bhrastacari - n. korrupte Person
bhugarbha vigyan - n. Geologig
bhugolko anusandhan karya - n. geologische Untersuchung
bhuin - n. Erde, Erdboden, Erdoberfl√§che
bhuin - n. Erde, Erdboden, Erdoberfl√§che, Fu√üboden
bhuincalo - n. Erdbeben
bhuinkatahar - n. Ananas
bhuja - n. Reis [gekocht] [nur hohe Hindukasten]
bhuknu - v.i. bellen
bhu-ksharan - n. Bodenerosion
bhulnu - v.i./v.t vergessen, einen Fehler machen
bhumi - n. Erde, Erdboden, Erdoberfl√§che
bhumigat - n. Untergrund
bhumika - n. Vorwort, Einleitung
bhundi - n. Magen
bhu-parivestit desh - n. Binnenland
bhusuno - n. Stechm√ºcke
bhutang - n. Bhutan
bhuteko makai - n. Popcorn
bhuteko masu - n. Gebratenes Fleisch
bhutla - n. Fell, pelz
bhutnu - v.t. braten
bhutpurva - adj. fr√ºher, gewesen, ehemalig 
bhutuva - n. gebratenes Fleisch
bhyaguto - n. Frosch
bhyaunu - v.i. Zeit finden
bich - n./postp. Mitte, Mittelteil, Zentrum, w√§hrend, unter 
bichar - n. Meinung, Idee, Vorstellung
bichhi - n. Skorpion
bigauti - n. Biestmilch, tiermilch nach der Gebuert eines Kalbs
biha - n. Hochzeit, Heirat
bihaite - adj. verherratet
bihana - n./adv. Morgen; am Morgen, morgens
bihivar - n. Donnerstag
bij - n. Samen, Saat
bijaropan - n. Grundsteinlegung
bijuli - n. Bitz, Electrizit√§t, Beleuchtung
bikha - n. Gift
bilkul - adj. v√∂llig, g√§nzlich
binti - n. Bitte, Gebet
bintipatra - Antrag, Petition
biralo - n. Katze
birami - n. Kranker, Patient, Krankheit, krank
birta - n. Landbesitz, der ohne steuerabgaben belastet ist
birtaval - Besitzer von Birta-Land
bis - num. zwanzig. 20
bitaunu - v.t. verbringen
biu - n. Samen, Saat
biunjhanu -v.t. aufwecken
bodi - n. eine Bohnenart
boknu - v.t. tragen, heben, begreifen, erfassen, verstehen
boko - n. Zeigenbock
bolaunu - rufen, herbeirfuen, einladen
bolbala - n. Macht, Allmacht, √ºberw√§ltigender Einflu√ü 
bolchal - n. Unterhaltung, Gespr√§ch
bolchalma -  in der Alltagssprache
bolinu - v.i. gesprochen werden
bolivachan - n. Unterhaltung, Gesprach
bolnu - v.i. sprechen, reden, sagen
brihaspatibar - n. Donnerstag
brihat - adj. gro√ü
buda ba - n. Gro√üvater [untere Gesellschaftsschichten]
buddhi - n. Wissen, Weisheit, Geisteskraft
buddichal - n. Schach
buddhijivi -  adj. intelligent, gelehrt
budhavar - n. Mittwoch
budhi ama - n. Gro√ümutter [untere Gesellschaftsschichten]
budhi aunlo - n. Daumen
budho - adj. alt [ bei Personen]
buhari - n. Shwiegertochter, Ehefrau des Sohnes
buigal - n. oberes Stockwerk, Dachgescho√ü, Mansarde
bujhaunu - v.t. erkl√§ren
bunda - n. Hauptpunkt
burundi - n. Design
buva - n. Vater, Papa [ Standard ]
bvanso - n- Wolf
byadmintan -  n. Badminton, Federball
cabaunu - n. kauen
chadhaunu - v.t. klettern lassen, besteigen lassen, anbieten [gegen√ºber H√∂hergestellten]
cadhnu - v.t. verbessern, erklettern, besteigen [Pferd, Zug,Auto, Leiter]
cadnu - v.t. erklettern, besteigen; verbessern
caharnu - v.t. herumlungern, tr√∂deln, verweilen, umherschweifen
cahinu - v.i. verlangt werden, gefordert werden
cait - n. zw√∂lfer Monat des nepalischen Kalendars [M√§rz/April]
cakhaunu - v.t. schmecken lassen, kosten lassen
cakhnu - v.t. schmecken, kosten
cakku -  n. Messer
cakramarg -  n. Rundweg
cal - n. Bewegung
calak - fahrer
calakh - adj. klug, schlau, klever, intelligent
calan -  n. Brauch, Sitte, Verhalten
calan - n. Verschickung, Versendung, Versenden
calan garnu -  v.t. benutzen
calaunu - v.t. bewegen, in Bewegung setzen, gebrauchen, benutzen, verwenden, beibehalten
calis - num. vierzig, 40
callo - n. K√ºken
calnu - v.i. sich bewegen, bestehen, functionieren, in Gang sein, getan werden, ausgeh√ºhrt werden, passend sein
caltika - adj. gebraÃàuchlich, in Umlauf, in Mode, uÃàblich
camada - n. Haut
camal - n. Reis [geschaÃàlt, aber ungekocht]
camca - n. LoÃàffel
camero - n.  Fledermaus, Vampir 
camkanu - v.i. glitzern, scheinen
camkaunu - v.t. polieren, zum GlaÃàntzen bringen
camkilo - adj. hell, leuchtend
camsur - n. [ein scharfe GemuÃàseart, die roh als Medizin gegessenwird]
canakya - n. [ein Name fuÃàr Kautilya, den Autor des Arthashastra]
cancun - adj. etwa, ungefaÃàhr, unvollstaÃàndig, verschieden
canda - n. Schenkung, Geschenk 
cadai - adv. bald
candi - n. Silber
chando - adj. schnell, bald, unmittelbar n. Mond
cangunarayan - n. Changunarayan [ein Ort im Kathmandutal]
cap - n. Bogen, Kreisausschnitt, Regenbogen
car - num. vier, 4
caraitira - adv. auf allen [vier] Seiten
caran - n. Fu√ü, Bein, erstes Viertel einer Strophe
caraunu - v.t. grasen lssen, weiden lassen
carca - n. Rede, GespraÃàch, ErzaÃàhlung, Besprechung, Unterredung, Anmerkung, Bemerkung
carit - n. Verhalten, Charakter, Arbeit, BeschaÃàftigung
caritra - n. Verhalten, Charakter, Arbeit, BeschaÃàftigung
carkanu - v.t. knacken, spalten
carkaunu - v.t. zum Spalten bringen, zum Knacken bringen
carkha - n. Spinnrad
carko - adj. hart, bitter, erbittert, schwer, schwierig, laut, pikant
carnu - v.i. grasen, weiden
caro - n. Vogel
cartarph - adv. auf allen [vier] Seiten 
cartarph - adv. auf allen [vier] Seiten v.t. lecken lassen
cataunu - v.i. lecken
caubar - adj. vierfach [beiGegenstaÃànden] 
caubis - num. vierundzwanzig, 24
cauda - n./adj. Weite, Breite; breit, weit 
caudai - n./adj. Weite, Breite; breit, weit 
caudha - num. vierzehn, 14
chauhattar - num. vierundsiebzig, 74
cauka - n. der E√üplatz am Herd 
cauntis - num. vierunddrei√üig,34  
caupattai - adj. aÃàu√üerst, sehr viel 
cauranabbe - num. vierundneunzig,94 
caurasi - num. vierundachtzig, 84 
causathhi - num. vierundsechzig, 64
cautara - n. ein vertrautes und zuverlaÃàssiges Mitglied der koÃàniglichen Familie, Plattform fuÃàr die Errrichtung eines Thrones
cautariya - n. Mitglied der koÃàniglichen Familie
cautarph - adv. auf allen [vier] Seiten 
cautho - adj. vierte, vierter
cavalis - num. vierundvierzig, 44 
cavanna - num. vierundfuÃànfzig, 54 
cavaunu - v.t. kauen, zermalmen 
cehara - n. Gesicht, Antlitz
celi - n. SchuÃàlerin
celibeti becvikhan - n. MaÃàdchenhandel
cepang - n. Chepang [eine Volksgruppe Nepals]
cetana - n. Intelligenz,Verstehen, Geist, Bewu√ütsein
cetauni - n. Warnung
ÃÅ
cetavani - n. Warnung
cetnu - v.i. bei Bewu√ütsein sein, aufmerksam sein, seine Sinne zusammenhalten
cha - num. sechs, 6
cha patra - adj. sechsfach [bei GegenstaÃànden]
chabbis - num. sechsundzwanzig, 26
chadnu - v.i./v.t. auswerfen, ausbrechen, sich uÃàbergeben
chadnu - v.t. aufhoÃàren, beenden, verlassen
chahari - n. Schatten [von BaÃàumen] 
chahattar - num. sechsundsiebzig, 76
chaisatthi - num. sechsundsechzig, 66
chaitaun -adj. sechste,sechster
chakkinu - v.i. betrogen werden, getaÃàuscht
werden, ausgetrickst werden
chakyaunu - v.t. LuÃàgen verbreiten, betruÃàgen, beluÃàgen
chala - n. Haut
chalnu - v.t. betruÃàgen, taÃàuschen, austricksen
chalphal - n. Diskussion, Debatte
chalphal garnu - v.t. diskutieren, besprechen 
chamnu - v.t. beruÃàhren, fuÃàhlen
chana - n. Dach
chanavin - n. Auswahl
chand - n. Metrum, Betonung,Prosodie
 channe - n. Filter, Sieb
channu - v.t. waÃàhlen, auserwaÃàhlen, filtrieren, aussieben,durchsieben
chantyal - n. Chantyal [eine Volksgruppe Nepals]
chapakhana - n. Druckerei, Presse
chapanna - num. sechsundfuÃànfzig, 56
chapinu - v.i. veroÃàffentlicht werden
chapnu - v.t. veroÃàffentlichen, publizieren, herausgeben
charnu - v.t. verstreuen, ausstreuen
chata - n. Schirm  
chati - n. Brust, Busen , Mut, Tapferkeit
chatra -  n. Student, SchuÃàler
charnu - v.t. verstreuen, ausstreuen
chata - n. Schirm
chati - n. Brust, Busen, Mut, Tapferkeit
chatra - n. Student, SchuÃàler
chatravas - n. Herberge, Pension, Studentenheim
chattis - num. sechsunddrei√üig, 36
chaunu - v.t. bedecken, zudecken, abdecken
chauro - n. KuÃàken, Junges
chaya - n. Schatten [generell]
chayalis - num. sechsundvierzig, 46
chaya - n. Schatten [generell]
chayalis - num. sechsundneunzig, 96 
chayasi - num. sechsundachtzig, 86
cheknu - v.t. anhalten,stoppen,hindern
chetri - n. Chetri, Kshatriya [der zweithoÃàchste Stand (varna) der hinduistischen Sozialhierarchie]
chimeki - n. Nachbar
chindi - n. Keller, Untergescho√ü, Basement
chiraanu - v.t. durchgehen lassen
chirkemirke - adj. gepunktet, gefleckt
chiraunu - v.i. durchgehen
chito - adj. schnell, bald, unmittelbar 
chodnu - v.t. aufhoÃàren, beenden, verlassen, aufgeben
chopnu - v.t. zudecken, bedecken, abdecken, abschirmen
chori - n. Tochter
choro - n. Sohn
choto - adj. kurz
chunu -  v.t. beruÃàhren
churavaji - n. Messerstecherei
chuskar - n. Verleumdung, Gerede
chutkara - n. Befreiung, Freilassung
chutnu - v.i. abfahren, sich trennen, uÃàbrigbleiben
chuvachut - n. UnberuÃàhrbarkeit, Verunreinigung
cihan - n. Grab, Friedhof, Verbrennungsplatz
cijbij - n. Dinge, Sachen, Waren
cikitsa - n. Behandlung, Medikation, Therapie
cikitsalaya - n. Krankenhaus
cil - n. Adler
cimotnu - v.t. kneifen, zwicken n. China
cinari - n. Vertrautheit, IntimitaÃàt, IdentitaÃàt 
cinaunu - v.t. vorstellen, zu erkennen geben
ciniyan - adj. chinesisch
cinnu - v.t. erkennen, identifizieren 
cinta - n. Angst, Sorge, kritische Betrachtung
cintan - n. das Denken, Nachdenken, Reflektion, UÃàberlegung,Meditation 
cintit - adj. traurig
ciplo - adj. schluÃàpfrig, glatt, glitschig 
cirnu - v.t. spalten, in zwei Teile hauen 
ciso - adj. kalt [Wasser, Temperatur], feucht
ciso pani - n. kaltes Wasser
cithi - n. Brief, schriftliche Nachricht n. Bild, GemaÃàlde, Illustration n. Denken, GefuÃàhl, Geist
cittha - n. Lotterie, GluÃàcksspiel
citthi - n. Brief, schriftliche Nachricht n. Leopard,Panther
cituva - n. Kinn
ciundo - n. flach geklopfter Reis
ciya - n. Tee
cod-patra - n. Scheidungsurkunde, Trennungsvertrag
cok - n. Hof, Innenhof
cokhinu - v.i. rein sein
cor - n. Dieb, RaÃàuber, Schwindler 
cornu - v.t. stehlen
cot - n. Wunde, Verletzung, Blutergu√ü, blauer Fleck n. Gipfel,Berggipfel
cuda - n. Krone
cudamani - n. (eine Art wertvolles Ornament, das auf dem Kopf getragen wird)
cuhinu - v.i. troÃàpfeln, lecken, undicht sein
cuhunu - v.i. troÃàpfeln, lecken, undicht sein
culensi - n. ein gebogenes Instrument zum Schneiden vonGemuÃàse
culo - n. Kochstelle, Herd
cultho - n. geflochtenesHaar,Zopf v.t. kuÃàssen, liebkosen
cuna - n. Kalk
cunauti - n. Herausforderung
cunav - n. Wahl,Auswahl
cunavi - adj. Wahl-, auf Wahlen bezogen 
cup lagnu - v.i. ruhig sein, still sein
curot - n. Zigarette
cusnu - v.t. saugen
cutai - n. Schlagen, SchlaÃàge, Dreschen
cutnu - v.t. schlagen, dreschen, pruÃàgeln
cyankhla - n. gemahlener Mais 
cyatnu - v.t. rei√üen, zerrei√üen n. Pilz
dabau - n. Druck
dabi - n. Behauptung, Anspruch v.i. brennen
dadu - n. SchoÃàpfloÃàffel
daguraunu - v.t. zum Rennen veranlassen 
dagurnu - v.i. rennen, laufen, hasten, eilen
daha - n. (natuÃàrlicher) Teich, TuÃàmpel
dahi - n. Yoghurt
dahine  - adj. rechts
dahri - n. Bart
daju - n. aÃàlterer Bruder 
dailo  - n. TuÃàr,Tor
daju - n. aÃàlterer Bruder
dajyu - n. aÃàlterer Bruder
daknu - v.t. rufen, herbeirufen
daksha - adj. faÃàhig, geeignet, begabt
dakshin koriya - n. South Korea
dal - n. Linsen
dal - n. Partei, Gruppe
dalal - n. Makler, Mittelsmann
dalbal - n. das Heer von AnhaÃàngern, die gesamte Partei
dalpati - n. Parteipolitik, Gruppenpolitik
dalcini - n. Zimt
dalit - n. Dalit, UnberuÃàhrbarer (aus Sicht der Brahmanen)
dallo - n. rundes Ding, Klumpen, Erdklumpen, Fetzen
dalo - n. Korb
dalpati - n. ParteifuÃàhrer, FuÃàhrer, AnfuÃàhrer
dalvihinata - n. Parteilosigkeit, Fehlen von Parteien
daman - n. UnterdruÃàckung
dampati  - n. Mann und Frau, Ehepaar 
damphu  - n. eine Art Trommel
dan - n. Gabe, Geschenk, Schenkung
dand - n. Strafe, Bestrafung
danda  - n. Berg, HuÃàgel, Bergzug
dandalnu - n. RuÃàcken
dandi - n. Pfahl, Stab
dando - n. Berg, HuÃàgel, Bergzug 
danphe - n. Himalaya-Fasan[Nationalvogel Nepals] 
dant - n. Zahn
dant majhnu - v.t. ZaÃàhne putzen 
dant malnu - v.t. ZaÃàhne putzen 
dant maskaunu - v.t. ZaÃàhne putzen 
dantko burus - n. ZahnbuÃàrste 
dantmanjan - n. Zahnpasta
danuwar - n. Danuwar [eine Volksgruppe Nepals]
dapha - n. Teil, Abschnitt [eines Gesetzes]
dar - n. Furcht, Angst
daraj - n. Schrank
daraunu - v.i. aÃàngstlich sein, Angst haben, sich fuÃàrchten 
darbar - n. Palast
dari - n. Bart
dari - n. Baumwollmatte
daridra - adj. arm, beduÃàrftig
darim - n. Granatapfel
darja - n. Stellung, Rang, Klasse,Standard 
darjan - n. Dutzend
darjiling - n. Darjeeling
darlagdo - adj. schrecklich, gefaÃàhrlich, furchtbar aus Furcht, aus Angst
darshan - n. Audienz, Vision, Erscheinung
das - num. zehn, 10
das - n. Sklave, Diener, AbhaÃàngiger n. Baumwolldecke,
dasans - Baumwollmatte [zum Liegen]
dasaun - adj. zehnte, zehnter
dashak sarvanam - n. Demonstrativpronomen 
dasi - n. Beweis, Nachweis,Wahrheit 
dasta - n. Sklaverei
dastavej - n. Dokument, Tat Geber, WohltaÃàter
datri sanstha  - n. Geberagentur
daudaha - n. Reise, Inspektion, juristische Kommissionen oder Untersuchungsteams zur Inspektion der Distriktverwaltungen
daura - n. Brennholz, Feuerholz 
dava - n. Behauptung
daya - n. Freundlichkeit, Gunst, Mitleid, MitgefuÃàhl, Erbarmen, Sympathie bemitleiden, bedauern 
dayan - adj. rechts
dayaniya - adj. mitleidserregend, bemitleidenswert
debre - adj. links
dedh baje - adv. halb zwei [Uhrzeit]
dekhaunu - v.t. zeigen
dekhi - postp. von, seit, nach [zeitl. u. oÃàrtl.] 
dekhinu - v.i. gesehen werden, erscheinen 
dekhnu - v.t. sehen
dera - n. Residenz, Wohnsitz, Lager, n. Land
deshantar - n. Ausland,LaÃànge[geographisch] 
deshbhakta - n. Patriot
deshbhakti - n. Patriotismus
deshraksha - n. Landesverteidigung, Landesschutz
devar - n. juÃàngerer Bruder des Ehemannes
devarani - n. Ehefrau des juÃàngeren Bruders des Ehemannes
devata - n. Gott, Gottheit
dhadas - n. Ermutigung, Hoffnung, Versicherung
dhango - n. Faden
dhakane - n. in Butter gebratener und anschlie√üend in Milchgekochter Reis
dhakdhakyaunu - v.t. hinuntersto√üen, hinunterdruÃàcken
dhaknu - v.t. bedecken, verstecken
dhamilo - adj. schmutzig, truÃàbe [FluÃàssigkeiten]
dhamki - n. Bedrohung
dhan - n. Wohlstand, Reichtum, Besitz, Eigentum, Geld
dhan - n. Reis [ungeschaÃàlt]
dhancha - n. Beschaffenheit, Art und Weise, Methode, Design
dhandha - n. Beruf
dhandhali - n. Chaos
dhani - adj. golden, guÃàlden
dhani - adj. reich
dhaniyan - n. Koriander
dhaniyanko sag - n. KoriandergruÃàn
dhantnu - v.i. luÃàgen
dhapaunu -  v.t. wegbringen, fortjagen
dhara - n. Wasserhahn
dharahara - n. [gro√üer] Turm
dharan - n. das Halten, das Innehaben 
dharana - n. Denken, Vorstellung, Neigung
dharatal - n. ErdoberflaÃàche
dharke - adj. gestreift
dharma - n. Religion, Pflicht, Glauben, Vertrauen, Lebensgesetz
dharmadeva - n. Dharmadeva [ein Licchavi- KoÃànig, Vater von Manadeva I.]
dharmadhikari - n. ein mit der Rechtsprechung beauftragter Beamter
dharmagranth - n. religioÃàse Schrift, religioÃàser Text
dharmashala - n. Rasthaus [fuÃàr religioÃàse Zwecke]
dharmavacak nam - n. Abstraktum
dharmik - adj. religioÃàs, auf den dharma bezogen
dharmik sthan n. religioÃàses Zentrum
dharna - n. das Warten
dharo - n. Quelle, Wasserquelle, Menschenstrom 
dhatu - n. Metall
dhau - n. Erz
dherai - adj. viel, viele
dherai aghi - adv. vor langer Zeit
dherai logne hunu - comp. Polyandrie pflegen
dherai vivaha - n. Polygamie
dherai vivaha garnu - comp. Polygamie betreiben 
dheraijaso - adj. viele, eine Menge, eine gro√üe Anzahl
dhiki - n. Maschine zum SchaÃàlen von Reis
dhimal - n. Dhimal [eine Volksgruppe Nepals]
dhindo - n. gekochte Mehlso√üe
dhoka - n. TuÃàr,Tor
dhukka - adj. frei von Angst, unbesorgt,unbeschwert, sicher 
dhukur - n. Taube
dhukuti - n. Scheune, Lagerhaus, Schatzkammer
dhunga - n. Stein
dhup - n. Sonnenschein, Sonnenhitze
adj. aschefarben, grau #
dhvanse - adj. dunkelbraun
dhyan - n. Meditation, Besinnung 
didi - n. aÃàltere Schwester
digo - adj. dauerhaft
din - n. Tag
dinahun - adj. taÃàglich
dinbhari - n. den ganzen Tag
dinu - v.t. geben
dirgha - adj. gro√ü, riesig
dirghakalin - adj. chronisch,anhaltend,langfristig 
disha - n. Richtung
diunso - adv. am Tage, tagsuÃàber
divas - n. Tag
dobar - adj. doppelt [bei GegenstaÃànden] adj. zu beiden seiten gehoÃàrend a
doklo - dj. doppelt [bei Lebewesen]
doko - n. gro√üerTragekorb
doreto - n. Fu√üpfad
dori - n. Seil, Strick, Schnur
dosi - adj. schuldig
dosro - adj. zweite, zweiter
dravyavacak nam - n. Sachbegriff
dristi - n. Sicht, Betrachtung
dristikon - n. Gesichtswinkel,Blickpunkt, Blickwinkel
dublaunu - v.i. duÃànn werden, schwach sein
dublo - adj. duÃànn, nicht fett
dubnu - v.i. versinken, untergehen, ertrinken
dubulki marnu - v.t. den entscheidenden Schritt wagen, den Sprung wagen
dudh - n. Milch
dugdha - n. Milch
dugdhasar - n. KaÃàse
dugurnu - v.i. rennen, laufen 
duhkhi - adj. traurig
duhunu - v.t. melken
dui - num. zwei, 2
dura - n. Dura [eine Volksgruppe Nepals]
duragraha - n. Voreingenommenheit, Vorurteil

durdarshita - n. Weitsicht,Klugheit, Scharfsinn
durgam - adj. entlegen
dursancar - n. Telekommunikation
durvavahar - n. Fehlverhalten
dusti - adj. fehlerhaft, mangelhaft,verunreinigt, kontaminiert 
dut- n. Bote, Gesandter, Kurier
dvandva - n. Paar, Duell, Streit 
dvara - postp. von, durch
dvija - n. Zweimal Geborener, Brahmane, eierlegend
dvitiya purus vachak - n. zweite Person [grammatisch]
dvitiyardha - n. zweite HaÃàlfte
dyotak - adj. offenlegend, ans Licht bringend
e - int. he! hallo! num. elf, 11
eghara - adj. elfte, elfter
ejan - n. ebenso, dito, dto., a.a.O. 
ek - num. eins, 1
ek baji - adv. einmal
ek chin - adv. fuÃàr kurze Zeit, fuÃàr einen Augenblick
ek coti  - adv. einmal 
ek khep - adv. einmal der eine oder andere 
ek palta - adv. einmal
ek saya dui - num. einhundertzwei, 102 
ek saya ek - num. einhunderteins, 101 
ekaarkalai - adv. einander,gegenseitig 
ekabihana - adv. sehr fruÃàh am Morgen 
ekadeshma - adv. in irgendeinem Land 
ekaki - adj. allein, einzeln, einsam
ekanabbe - num. einundneunzig, 91
ekanta - n./adj. Einsamkeit; allein einsam 
ekaunna - num. einundfuÃànfzig, 51
ekasi - num. einundachtzig, 81 
ekatira - adv. einerseits
ekcalis - num. einundvierzig, 41 adv. sehr
ekedami - n. Akademie
ekhattar - num. einundsiebzig, 71
ekikaran - n. Einigung, Vereinigung integriert, vereinigt 
ekkai coti - adv. gleichzeitig, auf einmal
ekkais - num. einundzwanzig, 21 
ekkasi - adv. ploÃàtzlich, auf einmal 
eklai - adv. allein, einzig, nur, ganz allein
eklauti - adj. monopolartig
eklo - adj. einzig, allein [bei Lebewesen]
eknas - adj. gleich, aÃàhnlich, einheitlich, monoton
ekohorinu - v.i. sich auf eine Sache konzentrieren
eksaro - adj. einzeln, allein [bei GegenstaÃànden]
eksatthi - num. einundsechzig, 61
ekta - n. Einheit, SolidaritaÃàt 
ektak - adv. unaufhoÃàrlich
ektis - num. einunddrei√üig, 31 
ektrit - adj. versammelt, vereint 
eproc - n. AnnaÃàherung, Zugang 
eshiyali - adj. asiatisch
eshiyali - adj. asiatisch
euta - adj. eins, ein [nicht-menschlich]
euta tukra jagga - ein kleines StuÃàck Land 
evamastu - adv. so sei es; Amen
evan - conj. und, folglich, also, sowie 
gada - n. Keule, KnuÃàppel, Kolben 
gadagad - adj. froh, erfreut, gluÃàcklich
gadar - n. Aufstand, Rebellion, Unruhe
gadda - n. Matratze, weiches und dickes Bett
gaddar - adj. revolutionaÃàr
gaddar - n. Schmutz, Matsch, Morast 
gaddar-posh - n. TuÃàrmatte zum Abreiben von Schmutz
gaddi - n. Thron, Kissen, Satteldecke
gaddu - n./adv. BaÃàrenkeule; nutzlos, wertlos
gadgad - schlammig, sumpfig, morastig
gadha - n. Esel
gadhapaccisi - n. Jugend
gadinarasing - adj. inthronisiert
gadnu - v.t. begraben
gadryak-gudruk - n. GeraÃàusch von Schritten oder Pferdehufen
gadryamma - n. GeraÃàusch hevrergerufen vom Fallen schwerer GegenstaÃànde 
gadya - n. Prosa
gadya-kavita - n. Prosadichtung
gadya-kavya - n. Prosa
gagri - n. Wasserkessel aus Metall 
gagro - n. ein gro√üer irdener oder metallener Wassertopf 
gahak - n. Kunde, KaÃàufer
gahaki - n. Kunde, KaÃàufer
gahiro - n. Linsen
gahiro - adj. tief
gahraun - adj. schwer [an Gewicht] 
gahraun - adj. schwer, schwierig 
gahro - adj. schwer (an Gewicht) 
gahun - n. Weizen
gai - n. Kuh
gaibastu - n. Rinder
gaihra - adj. ganz, alle, alles
gainda - n. Rhinozeros, Nashorn
gair sarkari sanstha - n. Nichtregierungsorganisation, NRO, NGO 
gairaprajatantrik - adj. undemokratisch
gajar - n. Karotte, MoÃàhre
gala - n. Wangen, Backen n. Teppich
galat - adj. falsch
gali - n. Schimpfe, Schelte, Beschimpfung
gali garnu - v.t. beschimpfen, ausschimpfen 
galli - n. Gasse
gamarkyaunu - v.t. greifen, packen, ergreifen, in Beschlag nehmen
gambhir - adj. tief, tiefgruÃàndig, gravierend
gangan - n. brummig, murrend
ganganahat - n. brummig, murrend
ganganaunu - v.i. brummig sein, murren 
gantantra - n. Republik
ganthan - n. Klatsch, Tratsch
ganthanaunu - v.t. Unsinn reden, tratschen 
gandagi - n. Filz, Schmutz
gandha - n. Geruch, Gestank
gandhadravya - eine suÃà√üriechende Substanz
gandhak - n. Schwefel
gandahkshat - n. (Sandelholz usw. fuÃàr puja) 
ghandarva - n. ein himmlicher Musikant, eine Art Halbgott 
gandharva-ved - n. Musikwissenschaft
gandharva-vidya - n. Musik, Musikwissenschaft
gandharva-vivaha - n. Liebesheirat, Heirat im gegenseitigenEinvernehmen ParfuÃàmeriehaÃàndler
gandhik - n. der Duft von ParfuÃàmeriehaÃàndlern
gandyaulo - n. Erdwurm 
gangato - n. Krabbe
ganja - n. Marijuana 
ganjagol - n. Verwirrung, Konfusion, Durcheinander, Chaos
ganji - n. Sweater, Pullover, Jackke, Weste, Unterhemd
ganjipha - n. (eine Art Kartenspiel)
gannu - v.t. zaÃàhlen, zusammenzaÃàhlen, rechnen
gans - n. Mundvoll, Brocken, Happen, Bissen
gansnu - v.t. verbinden,zusammenfuÃàgen n. Zahl, Nummer
gapashap - n. GeschwaÃàtz, Geschwafel, Klatsch, TratschSchwaÃàtzer, Prahler, Aufschneider
garaunu - v.t. machen lassen, tun lassen
garbha - n. Leib, Bauch, Unterleib, Foetus, Embryo
garerai chadnu - v.t. um jeden Preis ausfuÃàhren
garib - n./adj. Armer; arm, mittellos, beduÃàrftig
garibi - n. Armut, Not, Bescheidenheit
garjan-tarjan - n. Bedrohung, EinschuÃàchterung
garjanu - v.i. donnern,grollen,droÃàhnen, poltern
garmi - n. Hitze, WaÃàrme, hei√üe Jahreszeit, Sommer, hei√ü, warm [Wetter]
garna chodnu - v.t. aufhoÃàren ... zu tun
garna dinu - v.t. erlauben ... zu tun, machen lassen
garna thalnu - v.t. anfangen ... zu tun v.t. tun, machen
garo - n. Wand
gate - n. Datum [nach dem nepalischen Kalender]
gatha - n. Geschichte, ErzaÃàhlung, Vers, Lied
gathakar - n. ErzaÃàhler, Dichter
gathan - n. Formation, Formung, Bildung, Einrichtung, Konstruktion, Schaffung
gathaso - n. lange Geschichte von sich selbst;Unsinn
gati - n. Bewegung, Tempo, bedingung, Umstand
gatihara - adj. faul, traÃàge, untaÃàtig
gatiman - n. Bewegung, Tempo, Geschwindigkeit
gatishil - n. Bewegung, Tempo, Geschwindigkeit
gatividhi - n. Bewegung, AktivitaÃàt, TaÃàtigkeit, Zustand, Stand der Dinge
gatta - adj. hoffnungslos, mittellos
gattam - adj. hoffnungslos, mittellos
gatvar - adj. vergaÃànglich, sterblich
gaun - n. Dorf
gaun - adj. zweitrangig, untergeordnet, indirekt
gaun vikas samiti - n. Dorfentwicklungskomitee
gaunghar - n. Nachbar, Dorfnachbar, Dorfbewohner
gaunnivasi - n. Dorfbewohner
gaunthali - n. Schwalbe
gayab - adj. verschwunden
geru - adj. ockerfarben, rotbraun 
ghadi - n. Uhr
ghailo - n. ein gro√üer Wassertopf, ein gro√üer Krug
ghaite - adj. verletzt
gham - n. Sonnenschein, Sonne, Hitze, WaÃàrme
ghan - n. gro√üer Hammer, Wolke 
ghana - adj. dicht, fest
ghanta - n. Uhr
ghantaghar - n. Turmuhr
ghanti - n. Kehle, Schlucht, Tal, Gebirgspa√ü
ghar - n. Haus
ghar hernu - den Haushalt fuÃàhren, die Hausarbeit machen
gharelu udyog - n. Heimindustrie
ghatak - n. Faktor, Bestandteil
ghatana - n. Ereignis, Zwischenfall, Episode
ghataunu - v.t. etwas verringern, abziehen, subtrahieren
ghati - n. Kehle, Schlucht, Tal, Gebirgspa√ü
ghati - adj. weniger
ghatnu - v.i. abnehmen, weniger werden, sich verringern, sich vermindern
ghatta - n. GetreidemuÃàhle, WassermuÃàhle
ghatu - n. [ein Gurung-Tanz]
ghau - n. Wunde, Verletzung, GeschwuÃàr
ghiu - n. geschmolzene Butter
ghoda - n. Pferd, Pony, Gewehrbolzen 
ghoral - n. Himalaya-Wildziege
ghosana - n. ErklaÃàrung,Deklaration, Proklamation 
ghosanapatra - n. Manifest
ghosit - adj. erklaÃàrt, deklariert
ghumnu - v.i. spazierengehen, umherschweifen
ghunda - n. Knie
ghus - n. Bestechung, Bestechungsgeld
ghyampo - n. ein gro√ües irdenes GefaÃà√ü 
giddha - n. Geier
gija - n. Zahnfleisch
gilo - adj. matschig, pappig [Speisen], weich, uÃàberreif
girnu - v.i. fallen, tropfen, herunterkommen,degradiert werden 
glas - n. Glas
gobar - n. Kuhmist, Kuhdung [wie er von Hindus zum 'Reinigen' des Fu√übodens benutzt wird]
godam - n. Lager, Lagerhaus
godamel - n. JaÃàten des Unkrauts 
godavari - n. Godavari (ein Dorf im Kathmandutal] 
godnu - v.t. schwer schlagen
v.t. jaÃàten, ausrotten
gohi - n. Krokodil
golbhinda - n. Tomate
goli - n. kleiner Ball, Kugel, Gewehrkugel, Gescho√ü 
goli gantho - n. Fu√üknoÃàchel
golidvara mrityudanda - n. Todesstrafe durch Erschie√üen
goman sarpa - n. Kobra
gopal prasad rimal - n. Gopal Prasad Rimal [ein bedeutender nepalischer Dichter]
gopya - adj. vertraulich, geheim, privat
goro - adj. hellhaÃàutig, wei√ü
goru - n. Ochse [kastruiert]
gosthi - n. kleine Versammlung, Vortrag, Rede, Besprechung, Symposium
goth - n. Unterstand fuÃàr KuÃàhe, Kuhstall
graha - n. Planet
grahan - n. Annahme, Empfang, Erhalt n. Dorf
grenait - n. Granit
griha  - n. Heim, Haus, Wohnung, Residenz 
gulaphi - adj. rosa
guliyo - adj. suÃà√ü, zuckrig
gumaraha - adj. verpa√üt, verfehlt 
gumaunu - v.t. verlieren
gun - n. QualitaÃàt, Verdienst, Tugend, Verpflichtung 
gunabodhak - adj. qualitativ [grammatisch]
gundri - n. Matte aus Reis-, Weizen- oder Maisstroh 
gundruk - n. fermentiertes und getrocknetes GemuÃàse
gupta - adj. heimlich, verborgen, privat 
guptacar - n. Spion
gupti - n. Spion, Detektiv
guru - n. Lehrer, geistiger FuÃàher, Mentor
gurung - n. Tamu, Gurung [eine Volksgruppe Nepals]
guruvar - n. Donnerstag
guthi - n. eine religioÃàse Organisation, eine wohltaÃàtige Organisation, Trust, Pfand
gyan - n. Wissen, Intelligenz, Verstehen, Weisheit
gyani - n./adj. gelehrt, gebildet, intelligent, selbstbewu√üt, informiert, Wissender, Gelehrter 
gyapan - n. Memorandum
habba - n. Macht, StaÃàrke, FaÃàhigkeit, LeistungsvermoÃàgen
habbe - n. Macht, StaÃàrke, FaÃàhigkeit, LeistungsvermoÃàgen
hackanu - v.i. sich aÃàngstigen, zoÃàgern, zaudern
had - n. Knochen
hade badam - n. Mandel
hadpa - n. Konfiszierung
hadtal - n. Streik, Streikposten
haisiyat - n. Status, Rang, Verdienst, FaÃàhigkeit
hajar - num. tausend, 1.000
hajurama - n. Gro√ümutter
hajurba - n. Gro√üvater [laÃàndlich]
hjurbuva - n. Gro√üvater
hajurmuma - n. Gro√ümutter
hak - n. Recht, AutoritaÃàt, Anspruch
hal - n./adj. augenblickliche Zeit, augenblicklicher Zustand, im Augenblick, augenblicklich
halkhabar - n. Nachricht, Neuigkeit
halla - n. LaÃàrm, Krach
halnu - v.t. hineintun, hineingie√üen, servieren [Speisen]
haluka - adj. leicht [an Gewicht] 
haluko - adj. leicht [an Gewicht] 
halungo - adj. leicht [an Gewicht]
halluva - n. in Wasser gekochtes und mit Butter und Zucker vermischtes Mehl
halluvabed - n. eine Art suÃà√üe Frucht
hamala - n. Angriff, Attacke, Invasion pron. unser [mask.]
hango - n. Ast
haninu - v.i. sehr schnell laufen, sehr schnell fliegen 
hanknu - v.t. [etwas] fahren
hannu - v.t. schlagen, schie√üen, beschie√üen
hans - n. Ente, Gans, Schwan
hansa - n. Seele, inneres Wesen, Sein; Ente, Gans, Schwan
hasaunu - v.t. zum Lachen bringen
hanseuli - n. GelaÃàchter, Scherz, Spa√ü 
hansilo - adj. laÃàchelnd, froÃàhlich, heiter 
hans-kukhura palan - n. GefluÃàgelzucht, GefluÃàgelhaltung
hanso - n. LaÃàcheln, Lachen, GelaÃàchter
hanssi - n. GelaÃàchter, Scherz, Spa√ü 
harek - adj. jeder
haraunu - v.i. verlieren, unterliegen es ist verloren gegangen 
harbakhat - adv. immer, stets
hardam - adv. immer
hariya makai - n. Mais [auf dem Halm]
hariyo - adj. gruÃàn
hartakarta - n. Herr in allen Belangen 
hasil - adj. erworben, erreicht, erlangt 
hastagat - adj. erhaltene, empfangene
hastakala - n. Handarbeit, Kunsthandwerk 
hastakshar - n. Unterschrift, Handschrift 
hastakshep - n. Einschreiten,Unterbrechung  
hat - n. Hand
hat aunu - comp. in die HaÃànde fallen Hand anlegen
hatiyar - n. Waffe
hatkelo - n. HandflaÃàche
hatnu - v.i. sich zuruÃàckziehen, weggehen
hatteri - adv. Ausruf der UÃàberraschung oder desKummers
hatti - n. Elefant
hatya - n. Mord, Morden, Ermordung, ToÃàten, ToÃàtung, Totschlag
hava - n. Luft, Wind, Briese a
havai - adj. luftig, Luft-
havajahaj - n. Flugzeug
havai marg - n. Luftweg, Luftstra√üe 
havai-dank - n. Luftbrief, Aerogramm 
havaijahaj - n. Flugzeug
havan - n. Feueropfer
havapani - n. Klima, Wetter 
havas - o.k., in Ordnung [hoÃàflich] 
hemanta - n. SpaÃàtherbst
herunu - v.t. ansehen, betrachten, sehen, hinsehen, blicken, hinblicken
herpher - n. Wechsel, Austausch, VeraÃànderung, Rotation, Manipulation 
hijo - adv. gestern
hijo rati - adv. letzte Nacht, vorige Nacht 
hijoaja - adv. heutzutage
himalaya pradesh - n. Himalayaregion
himarekha - n. Schneegrenze
himasrot bhaeko nadi - n. Schmelzwasserflu√ü
him-marubhumi - n. KaÃàltewuÃàste, Tundra 
hin - adj. niedrig, untergeordnet 
hindi - n. Hindi
hindnu - v.i. gehen, losgehen, sich aufmachen, aufbrechen 
hira - n. Diamant
hit - n. Gewinn, Vorteil, Benefit, Nutzen
hiun - n. Schnee
hoco - adj. niedrig, kurz
hodabaji - n. Wettstreit, Wettbewerb
hosh - n. Geist, Verstand, EinfuÃàhlungsvermoÃàgen, Intelligenz
hosh garnu - v.t. vorsichtig sein
hoshiyar - adj. vorsichtig
hoshiyari - n. Vorsicht,Sorgfalt, Intelligenz, Klugheit
hotel - n. Hotel
hotel - n. Herz,Geist,Wille
hukka - n. Wasserpfeife
hulak adda - n. Postamt
hundi - postp. waÃàhrend
huri - n. starker Wind, Sturm stuÃàrmen, stuÃàrmisch sein
hyolmo - n. Hyolmo [eine Volksgruppe Nepals]
ichha - n. Wunsch, Verlangen, Wille
ichhit - adj. gewuÃànscht, verlangt, begehrt
ichhuck - adj. interessiert
ijjat - n. Ehre, Status, Respekt
ikh - n. Eifersucht, Neid, Mi√ügunst, Rache
ikh phernu - v.t. Rache nehmen
ilaka - n. Jurisdiktion, Besitz, kontrolliertes Gebiet
ilam - n. Ilam (ein Distrikt in Ostnepal)
ilame - n. Bewohner Ilams
iman - n. Wahrheit, Glaube, Ehrlichkeit, IntegritaÃàt
imandar - adj. ehrlich, rechtschaffen, zuverlaÃàssig
imandari - n. Wahrheit, Glaube, Ehrlichkeit, IntegritaÃàt
indriya - n. Sinn, Sinnesorgan
inklan - n. Revolution
int - n. Ziegel, Backstein
irada - n. Wunsch, Verlangen, Wille, Plan, Vorhaben, Bestreben 
irsya - n. Eifersucht, Mi√ügunst, Neod
irsyalu - adj. eifersuÃàchtig, neidisch
ishara - n. Geste, Zeichen, Hinweis, Wink
ishvar - n. Gott
ista - adj. gewuÃànscht, verlangt 
itar - adj. andere, anderer
itihas - n. Geschichte
itihasik - adj. historisch, geschichtlich 
itihaskar - n. Historiker, Geschichtsschreiber 
itrinu - v.i. boshaft sein
ityadi - conj. etc., usw.
iyarphon - n. KopfhoÃàrer, HoÃàrgeraÃàt 
jado - n./adj. kalte Jahreszeit, Winter, KaÃàlte, kalt
jaga - n. Grundlage, Fundament
jagaran - n. das Erwachen
jagat - n. Universum, Welt
jagga - n. Land, Feld, GrundstuÃàck
jagir - n. Dienst, BeschaÃàftigung, Job, Bezahlung, monatliches Gehalt
jagnu - v.i. aufwachen, wach sein, aÃàrgerlich sein
jahaj - n. Schiff
jahan - pron. wo [Relativpronomen]
jahan - n. Familienmitglied, Familie 
jal - n. Wasser
jalaunu - v.t. anzuÃànden, entfachen, entflammen
jali - n./adj. immitiert, gefaÃàlscht, nachgemacht
jalnu - v.i. brennen, angezuÃàndet sein, entfacht sein
jal-shakti - n. Wasserkraft
jalvayu - n. Klima
jalvayuko prabav - n. klimatischer Einflu√ü
jal-vibhajak - n. Wasserscheide
jam - n. Rost, Bodensatz, Stau, GedraÃànge
jama - adv. zusammen, total, alles in allem
jamaunu - v.t. festigen, gefrieren lassen 
jamin - n. Feld, Ackerland
jamma - adv. zusammen, total, alles in allem
jamnu - v.i. gefroren sein, sich verdichten
jana - n. (ZaÃàhlwort fuÃàr Personen, jeweils der Zahl nachgestellt)
jana-andolan - n. Volksbewegung
janacetana - n. ethnisches Bewu√ütsein, Nationalbewu√ütsein
janaganana - n. Zensus, VolkszaÃàhlung
janai - n. die heilige Schnur eines Brahmanen
jana-jagaran - n. oÃàffentliches Erwachen, Renaissance
janajati - n. NationalitaÃàt, ethnische NationalitaÃàt
janajivan - n. oÃàffentliches Leben
janakari - n. Wissen, Kenntnis, information
janapakshiya -adj. die Seite des Volkes betreffend
janapravad - n. GeruÃàcht,Gerede
jana-sahabhagita - n. oÃàffentliche Beteiligung, Beteiligung der Allgemeinheit 
janasamaksha - comp. in der OÃàffentlichkeit
janasankhya - n. BevoÃàlkerung
janashruti - n. GeruÃàcht, Gerede 
janasvasthya - n. Volksgesundheit
janata - n. Volk, Leute, Menschen, OÃàffentlichkeit, Masse, Menschheit, BevoÃàlkerung 
janatantravad - n. Demokratie
jantantrik - adj. demokratisch
janavad - n. ein politischer Grundsatz, wonach das Staatsoberhaupt vom Volk gewaÃàhlt werden mu√ü
janavar - n. Tier, Vieh
janc - n. PruÃàfung, Test
jancnu - v.t. testen, pruÃàfen, untersuchen 
jand - n. Bier
jangal jamaune kam - n. Aufforstung
jangal tayar parne -  n. Aufforstung
jangali - adj. wild, unkultiviert, unzivilisiert 
janieko - adj. bekannt
janjal - n. weltliche Dinge, Familie, Frau und Kinder
janma - n. Geburt, Leben, Produktion 
janmabhumi - n. Geburtsort
janmadar - n. Geburtenrate
janmadata - n. GruÃànder, BegruÃànder
janmanu - v.i. geboren werden
janmat - n. oÃàffentliche Meinung
janmathalo - n. Geburtsort, Heimatort, Ursprungsort, Platz der Herkunft
janmaunu - v.t. gebaÃàren, zeugen
janmeko - adj. geboren
jannu - v.t. wissen, kennen 
jantantra - n. Demokratie, Volksdemokratie
janto - n. HandmuÃàhle [zum Mahlen von Getreide], MuÃàhlstein,Mahlstein 
janu - v.i. gehen
japnu - v.t. ehrfurchtsvoll ansprechen, als Gebet wiederholen
jarayo - n. eine Art Rotwild
jari - adj. fortgesetzt, gegenwaÃàrtig, augenblicklich
jarivana - n. Bestrafung, Strafe, Geldstrafe
jarimana - n. Bestrafung, Strafe, Geldstrafe
jaruri - adj. dringend, sofortig 
jasta - n. Zinn
jastai - conj. wie, z.B.
jasto - conj. wie, z.B.
jaso dekhincha - comp. sieht aus wie ...
jasto sunincha - comp. hoÃàrt sich an wie ..., klingt wie ...
jat - n. Klasse, Kaste
jati - adv. so viel [wie], etwa, ungefaÃàhr [bei Zeit u. Anzahl]
jatiavacak nam - n. Gattungsbegriff
jatiya - adj. national, die Nation betreffend
jatpat - n. Kastensystem
jau - n. Gerste
javab - n. Antwort
javan - n. junger Mann, JuÃàngling 
javaph - n. Antwort
javaphdehi - n. Verantwortung, Verantwortlichkeit, Verpflichtung
jaya - n. Sieg, Gewinn, Profit
jayaprakash malla - n. Jayaprakash Malla [letzter Malla-Herrscher von Kathmandu]
jehandar - adj. intelligent
jel - n. GefaÃàngnis
jeth - n. Monat des nepalischen Kalenders [Mai/Juni]
jethaju - n. aÃàlterer Bruder des Ehenmannes
jethan - n. Ehefrau des aÃàlteren Bruders
jethani didi - n. Ehefrau des aÃàlteren Bruders des Ehemannes
jethi sasu - n. aÃàltere Schwester der Eehfrau
jetho - n. AÃàltester [von BruÃàdern]
jhangad - n. Streit, Zank, Hader, Zwist, Disput
jhalkanu - v.i. scheinen, glitzern adj. hell, klar, leuchtend 
jhamtanu - v.t. angreifen, anfallen,anspringen 
jhan - adv. mehr 
jhan jhan - mehr und mehr 
jhanda - n. Flagge, Fahne
jhantnu - v.t. dreschen [Reis], zurechtweisen, tadeln, ausschimpfen
jharnu - v.i. fallen, hinabsteigen, herunterkommen
jhaskanu - v.i. erschrocken sein, sich ploÃàtzlich fuÃàrchten
jhiknu - v.t. herausnehmen
jhinge macha - n. Krabbe
jhingo - n. Fliege, Hausfliege
jhol - n. BruÃàhe, Suppe
jhuknu - v.i. sich buÃàcken, sich beugen 
jhunda - n. Menge, Gruppe, Versammlung
jhutho - adj. falsch, unrichtig, erlogen
jhuto - adj. falsch, unrichtig, unwahr,
jhyal - n. Fenster
jyalkhana - n. Gef√§ngnis
jibro - n. Zunge
jilla - n. Distrikt
jilla pramukh adhikari - oberster Distriktbeamter [in der panchayat-Zeit], CDO Distriktentwicklungskomitee , DDC
jimma - n. Verantwortung 
jimmewari - n. Verantwortung 
jindagi - n. Leben
jirel - n. Jirel [eine Volksgruppe Nepals]
jit - n. Sieg, Erfolg, Triumph gewinnen
jiu - n. KoÃàrper
jiundo - adj. lebendig
jiunu - v.i. leben
jivajantu - n. Lebewesen
jivan - n. Leben, Dasein, Existenz 
jivani - n. Lebensgeschichte, Lebenslauf
jivanshaili - n. Lebensweise, Lebensstil
jivjantu - n. Tier, Lebewesen
joban - n. Jugend, PubertaÃàt, JugendbluÃàte
jod - n. Addition, Summe
jodi - n. Paar
jodnu - v.t. sammeln, einsammeln, hinzufuÃàgen, addieren 
joi - n. Ehefrau
jokhnu - v.t. wiegen, waÃàgen
jotnu - v.t. anschirren, einspannen, nutzbar machen
juhar - n. Juwel, Edelstein
juka - n. Blutegel
juktanu - v.i. bevorstehen, sich treffen julus
julus - n. Prozession, Umzug
jumra - n. LaÃàuse
jun - n. Mondschein
jun - pron. welche, welcher [relativ] 
junaph - n. Gegenwart
junar - n. Orange
junelo - n. gro√üeHirse
junga - n. SchnaÃàutzer, Schnautzbart n. GluÃàhwuÃàrmchen
junsukai - pron. wer auch immer
juramuraunu - v.i. aktiv sein, taÃàtig sein, bereit sein, sprungbereit sein 
jut - adj. Gruppe, Partei
jutaunu - v.t. sammeln, zusammensammeln
juthyaunu - v.t. beschmutzen
jutnu - v.i. bevorstehen, sich treffen 
jutta - n. Schuh, Stiefel, Sandale 
juva - n. Spiel, GluÃàcksspiel 
juva khelnu - v.t. [GluÃàcksspiel] spielen
jvain - n. Schwiegersohn, Ehemann der Tochter
jyada - adj. aÃàu√üerst, sehr, viel 
jyadai - adj. aÃàu√üerst, sehr
jyestha - n. zweiter Monat des nepalischen Kalenders [Mai-Juni]
jyotirvidya - n. Astronomie, Astrologie 
jyotis - n. Astronomie, Astrologie 
jyotisi - n. Astronom, Astrologe 
kabja - n. Besitz, Zugriff
kachauro - n. Tasse
kachuva - n. SchildkroÃàte
kacinggal - n. Streit, Disput
kada - adj. unfreundlisch, barsch, hart, grausam 
kadam - n. Schritt
kadar - n. Respekt, EinschaÃàtzung, WuÃàrdigung
kag - n. KraÃàhe, Rabe
kagati - n. Zitrone
kahalaunu - v.i. genannt werden, beruÃàhmt sein
kahan - pron. wo?
kahan pani - adv. nirgendwo, nirgends
kahani - n. Geschichte, ErzaÃàhlung, Fabel
kahile - pron. wann
kahile kahin - adv. ab und zu, manchmal 
kahin - adv. wo auch immer
kahin kahin - adv. an einigen Stellen, mancherorts
kahinlo - n. ViertaÃàltester [von BruÃàder]
kaid - n. Inhaftierung, Verhaftung, GefaÃàngnis
kaid garnu - v.t. verhaften
kaidi - n. Gefangener
kaidkhana - n. GefaÃàngnis
kailo - adj. hellbraun [Haar]
kainyo - n. Kamm
kaiphat - n. Feststellung, Bemerkung, Anmerkung
khaiphiyat - n. Feststellung, Bemerkung, Anmerkung
kaiyaun - adj. viele, unzaÃàhlige
kaiyun - adj. viele, unzaÃàhlige
kaj - n. Job, TaÃàtigkeit, Beruf
kaju - n. Cashewbaum, Nierenbaum 
kaka - n. Vaters Bruder
kakh - n. Vorsto√ü, Vorsprung, Falz, Seite, KoÃàrperseite 
kakhi - n. AchselhoÃàhle
kaki - n. Vaters Bruders Ehefrau
kakrinu - v.i. steif vor KaÃàlte sein, starr sein
kakryaunu - v.t. steif machen, starr machen
kal - n. Zeit, Zeitalter, Alter, Tod
kala - n. Kunst, Handwerk, Technik 
kalaha - n. Streit, Disput
kalakar - n. KuÃànstler, Techniker
kalakaushal - n. Kunsthandwerk
kale - n. ein dunkelhaÃàutiger Mensch 
kaleji - adj. dunkelrot
kalejo - n. Leber
kaligad - n. Handwerker
kalij - n. Fasan
kalilo - adj. frisch, jung, zart
kalo - adj. schwarz
kalo dal - n. schwarze Linsen
kalo mas - n. schwarze Linsen
kalpa - n. AÃàra, Zeitalter
kalpana - n. Vorstellung, Imagination
kalpanashakti - n. Vorstellungskraft
kalyan - n. Wohl, Wohlfahrt, Wohlergehen, GuÃàte
kalyanakari - adj. freundlich, wohlgesonnen
kam - n. Arbeit, BeschaÃàftigung, Job, Aufgabe
kam - adj. klein, gering, wenig, weniger
kam garnu - v.t. arbeiten
kamai - n. Einkommen, Verdienst 
kamaunu - v.t. verdienen, kultivieren, anbauen
kamaunu - n. BeschaÃàftigter, Angestellter, Agent
kamej - n. Hemd
kamero - n. wei√üer Lehm zum Streichen von WaÃànden
kamilo - n. Ameise
kamjori - n. SchwaÃàche, KlaÃàglichkeit, IneffektivitaÃàt
kamkaj - n. AktivitaÃàt, BeschaÃàftigung, Arbeit
kammal - n. Decke [zum Zudecken]
kammar - n. Taille
kamnu - v.i. zittern, beben
kamta - adj. weniger, unzureichend 
kamti - adj. weniger, unzureichend 
kan - n. Ohr
kancat - n. SchlaÃàfe
kancho - n. juÃàngste Tochter, ein huÃàbsches MaÃàdchen
kanchi - n. JuÃàngster [von BruÃàdern]
kanco - adj. roh, unreif
kand - n. Kapitel, Zwischenfall, Ereignis 
kandha - Schulter 
kandhinu - v.i. fett sein [vom Essen]
kando - n. Dorn
kanggal - adj. mittellos, arm 
kanko loti - n. OhrlaÃàppchen 
kankro - n. Gurke
kano - adj. blind
kanparo - n. SchlaÃàfe
kanso - n. Bronze
kanta - n. Gabel
kantipur - Kantipur [mittelalterlicher Name fuÃàr Kathmandu]
kanun - n. Gesetz, Statut, Regelung, Verordnung entsprechend dem Gesetz, in UÃàbereinstimmung mit dem Gesetz
kapada - n. Stoff
kapal - n. Kopfhaar, Haupthaar, Kopf 
kapal kornu - v.t. das Haar kaÃàmmen
kapal nuhaunu - v.t. Haare waschen
kaphi - n. Kaffee
kapnu - v.t. schnitzen, mei√üeln
kar - n. Auto
kar - n. die Steuer
kara - n. GefaÃàngnis, Inhaftierung
karadanda - n. GefaÃàngnisstrafe, Haftstrafe n. GefaÃàngnis
karagar - n. GefaÃàngnis
karagriha - n. Kochtopf [mit breiter OÃàffnung] 
karamat - n. Wunder
karan - n. Grund, Ursache, Anla√ü, Motiv
karaunu - v.i. [laut] schreien
karavas - n. GefaÃàngnisstrafe, Haftstrafe n. Steuerzahler, das Steuerzahlen
karelo - n. a kind of bitter vegetable
karib - adv. fast, beinahe
karigar - n. Handwerker
karkhana - n. Fabrik, Werkstatt
karma - n. Tat, Handlung
karmacari - n. Angestellter,Beamter 
karod - num. Karor, 10 Millionen, 1.00.00.000
kartavya - n. Pflicht,Aufgabe
kartik - n. siebter Monat des nepalischen Kalenders [Oktober/November] 
karuva - n. Messingtopf mit TuÃàlle
karya - n. Aufgabe, Arbeit, Tat, Handlung, Funktion
karya samiti - n. Arbeitsausschu√ü
karyakarini - adj. vollziehend
karyakram - n. Programm,Prozedur
karyalaya - n. BuÃàro
karyanvayan - n. AusfuÃàhrung, Verwirklichung 
karyapalika - n. Exekutive
karyashala - n. Workshop
kasari - pron. wie? auf welche Weise?
kasaundi - n. Kochtopf [mit schmaler OÃàffnung] 
kasle lagyo - comp. wer hat [es] weggenommen?
kasnu - v.t. festziehen, enger machen
kast - n. Kummer, Leid, Problem, Sorge, Not, AÃàrger
kasturi - n. Moschustier
katahar - n. (jack-fruit)
kataunu - v.t. abschlagen lassen, koÃàpfen lassen 
katauro - n. Tasse
katha - n. Geschichte, ErzaÃàhlung 
katha halnu - comp. eine Geschichte erzaÃàhlen 
kathan - n. AÃàu√üerung, Feststellung 
kathin - adj. schwer, schwierig
kathinai - n. Schwierigkeit
kathit - adj. genannt, erwaÃàhnt
kathor - adj. hart, rauh, streng, undfreundlich, grausam
kati -  pron. wieviel, wieviele
kati baje ? - comp. um wieviel Uhr?
kati bajyo ? - comp. wie spaÃàt ist es? wieviel Uhr ist es?
kati bhayo ? - comp. wieviel kostet es? wieviel macht es?
katima ? - comp. fuÃàr wieviel?
katinu - v.i. abgeschnitten werden, abgeschlagen werden
katipaya - adj. einige
katnu - v.t. abschneiden, abtrennen 
kattar - adj. orthodox, streng, knochenhart, hartnaÃàckig, reaktionaÃàr
kauli - n. Blumenkohl
kavi - n. Dichter, Poet
kavita - n. Gedicht
kayam - adj. gewi√ü, sicher
kayam garnu - comp. einen Termin festsetzen pron. was?
kehi - adj. etwas, irgendetwas
kehi kura ko anurodh garnu - comp. um etwas bitten, ersuchen
kehi kurako mato milnu -  comp. etwas vereinbaren, ein Abkommen schlie√üen uÃàber etwas
kehi kurama anurodh garnu- comp. um etwas bitten, ersuchen
kelaunu - v.t. sieben, Unreinheiten entfernen
kendrit - adj. zentriert, konzentriert 
kera - n. Banane
kerau - n. Erbse
kesari - adj. saffranfarben
kesh - n. Kopfhaar
ketaketima - comp. in der Kindheit
keti - n. MaÃàdchen
keto - n. Junge
keval - adv. nur, lediglich, alleinig, einzig
khabar - n. Nachricht, Botschaft
khabarpatrika - n. Zeitung
khacar - n. Maultier
khada - adj. aufrecht, gegenwaÃàrtig, praÃàsent
khadkundu - n. gro√üer Kochtopf [mit zwei Griffen]
khandukunlo - n. gro√üer Kochtopf [mit zwei Griffen]
khadyanna - n. Nahrungsgetreide 
khagat - n. Papier
khairo - adj. braun
khaja - n. Imbi√ü
khajasaja - n. Imbi√ü
khajur - n. Dattel
khala - n. Au√üenhaut, aÃàu√üere Hautschicht 
khaldo - n. Tal
khali - adj. leer, unbesetzt
khamba - n. Pfeiler, SaÃàule
khanaunu - v.t. graben lassen
khanchi - n. Khanchi [einer der Kleinstaaten des westlichen Nepal]
khanco - n. Notwendigkeit, Bedarf
khand - n. Kapitel, Teil, Sektion, Ereignis
khandan - n. Widerlegung, Gegenbeweis
khandit - adj. gebrochen, fragmentiert, aufgesplittert
khanekura - n. Speise, Nahrung, Essen 
khani - n. Mine, Bergwerk
khanij - n. Mineral
khanjij padartha - n. Mineralprodukt
khaninu - v.i. ausgegossen werden 
khannu - v.t. graben
khanu - v.t. essen
khanyaunu - v.t. ausgie√üen
khapat - n. Verbrauch, Verkauf, Nachfrage
khappar - n. SchaÃàdel
kharab - adj. schlecht, boÃàse 
kharab - num. 100 Milliarden, 1.00.00.00.00.000
kharani - Asche, aschefarben, grau
kharau - n. Holzsandale
kharaunu - v.t. streng braten
kharayo - n. Hase
kharca - n. Ausgaben
kharidnu - v.t. kaufen, erwerben 
kharij - adj. zuruÃàckgewiesen 
khas - adj. wirklich, wahr, eigen 
khasaunu - v.t. fallen lassen
khasi - n. kastrierte Ziege
khasaunu - v.i. fallen, herunterfallen, sterben
khasro - adj. grob, roh
khat - n. SchalfstaÃàtte
khatam - n. Ende, Schlu√ü, Abschlu√ü 
khednu - v.t. jagen, verfolgen
khel - n. Spiel
kheladi - n. Spieler
khelaunu - v.t. spielen lassen
khelnu - v.t. spielen
kher - n. Zeit, Zeitdauer
kheri - postp. waÃàhrend
kheti - n. Landwirtschaft,Kultivierung 
kheti garnu - v.t. das Feld bestellen, Landwirtschaft betreiben
khetikamai - n. landwirtschaftliche EinkuÃànfte
kheti-pati - n. Landwirtschaft, Kultivierung
khicadi - n. [eine Mischung aus Reis und Linsen]
khicalo - n. Einmischung, Einschreiten, Einwand
khicolo - n. Einmischung, Einschreiten, Einwand
khir - n. Reispudding, Milchreis pron. wo ist [es]
khoj - n. Forschung, Erforschung, Untersuchung
khoji - n. Suche, Untersuchung, Forschung, Erforschung
khojkhabar - n. Nachforschung, Untersuchung
khojnu - v.t. suchen
kholnu - v.i./v.t. oÃàffnen, aufmachen, sich oÃàffnen
kholo - n. Bach, kleiner Flu√ü, Rinnsal
khopo - n. ein kleines Loch in der Wand zum Abstellen von GegenstaÃànden
khoriya - n. unkultiviertes Land, Naturpark
khorsani - n. roter Pfeffer, Chilli
khosuva - n. Stehler, Dieb
khudkila - n. Stufen [einer Treppe]

khukuri - n. Khukuri
khumcinu - v.i. schrumpfen, einschrumpfen, einlaufen
khunda - n. eine Art Schwert, eine Art KrummsaÃàbel 
Khushi - Freude, VergnuÃàgen, erfreut, froh, zufrieden
khusi - adj. froh
khutukka - n. GeraÃàusch,daskleine GegenstaÃànde erzeugen, wenn man sie fallen laÃà√üt
khutto - n. Bein
khuvanunu - v.t. fuÃàttern, essen lassen 
ki - conj. oder
kilakile - n. ZaÃàpfchen [im Rachen] 
kimbu - n. Maulbeere
kina - pron. warum?
kinabhane - conj. da, weil
kinamel garnu - v.t. EinkaÃàufe machen, einkaufen 
kinnu - v.t. kaufen
kintu - conj. aber
kinvadanti - n. GeruÃàcht,Gerede, Falschaussage, falscher Bericht, GeruÃàcht 
kira - n. Wurm
kiraya - n. Miete, GebuÃàhr
kiro - n. Insekt, Wurm
kirtiman - adj. beruÃàhmt, gefeiert, bekannt 
kisam - n. Art, Sorte, Gattung, Klasse, Spezies 
kisan - n. Bauer
kisam - n. Art, Sorte, Gattung, Klasse, Spezies
kismis - n. Rosinen
kisti - n. Tablett, Servierbrett 
kitli - n. Kessel
kitnu - v.t. mitden ZaÃàhnen knirschen, entscheiden, festlegen, spezifizieren, angeben, loÃàsen
kodali - n. Spaten [mit kurzem Griff] 
kodalo - n. Spaten [mit langem Griff] 
kodo - n. Hirse
kohi - adj. jemand, irgendjemand
koila - n. Kohle
koili - n. Kuckuck
kop - n. AÃàrger, Zorn
kop - bhajan - n. Opfer des Zorns
kopila - n. Knospe
koriya - n. Korea
kornu - v.t. kratzen
kos - n. ein LaÃàngenma√ü [ca. 2 Meilen]
koshish - n. Versuch, BemuÃàhung
koshish garnu - v.t. versuchen 
kot - n. Mantel
kotha - n. Zimmer
kotparva - n. [Staatstreich von 1846, mit dem Jang Bahadur die Rana-Familie an die Macht brachte] nach dem Staatsstreich von 1846
kotyaunu - v.t. picken, kratzen, [in der Nase] bohren
kram - n. Serie, Kette, Reihe, Ordnung, Anordnung
kramashah - adj. stufenweise, Schritt fuÃàr Schritt, teilweise, zum Teil, nach einander 
krambodhak - n. Ordnungszahl
kramjor - adj. schwach, ineffektiv
kranti - n. Revolution, Bewegung, UÃàbergang
krishna paksha - comp. dunkle MonatshaÃàlfte [des astrologischen Kalenders]
krisi - n. Landwirtschaft
krisi utpadan - n. landwirtschaftliche Produktion
kritagya - adj. dankbar
kriyakalap - n. Funktionen, Riten, Zeremonien
kriyapad - n. Verb
kriyayogi - n. Adverb
kshamata - n. FaÃàhigkeit, VermoÃàgen, Macht
kshetra - n. Feld, Gebiet
kshetraphal - n. Landprodukte,FeldfruÃàchte, Gebiet
kucakra - n. Intrige, VerschwoÃàrung
kuco - n. Besen
kucyaunu - v.t. zerquetschen, zerdruÃàcken 
kudnu - v.i. rennen, laufen
kuhino - n. Ellbogen
kuhuno - n. Ellbogen
kuhunu - v.i. faulen, modern
khukhurako bhale - n. Hahn
kukhurako pothi - n. Henne
kukhuri - n. Henne
khukhuro - n. Huhn
kukur - n. Hund
kul - n. Abstammung, Herkunft, Rasse, Lineage, Stammbaum
kumari - n. Prinzessin, unverheiratete Frau
kun - adj. welcher
kuncahin - adj. welcher, welche, welches 
kund - n. TuÃàmpel, Teich, der See 
kundnu - v.t. hauen, faÃàllen, schnitzen 
kunni - . adv. ich wei√ü nicht, vielleicht, moÃàglicherweise 
kuposan - n. UnterernaÃàhrung
kura - n. Wort, Rede, Unterhaltung, GespraÃàch, Ding
kurakani - n. Unterhaltung, Konversation, GespraÃàch
kurauni - n. fast kart gekochte Milch 
kurnu - v.t. warten
kursi - n. Stuhl
kushal - n./adj. GluÃàck, Wohlbefinden. geschickt, gewandt
kushasan - n. Mi√üwirtschaft,schlechte Verwaltung
kusti - n. Ringen ringen
kutpit - n. Schlagen,Dreschen 
kutnaitik kshetra - n. strategisches Gebiet 
kutnu - v.t. schlagen
kuva - n. Brunnen
kvartj - n. Quarz 
kyare - ich schaÃàtze, ich nehme an
n. Wert, Bedeutung, Profit, Gewinn
lacar - adj. unfaÃàhig, hilflos
ladain - n. Krieg, Schlacht
ladnu - v.i./v.t. fallen, kaÃàmpfen, bekaÃàmpfen 
lagabhaga - adv. ungefaÃàhr, fast
lagaeko - adj. gebraucht
lagani - n. Investition
lagaunu - v.t. gebrauchen, benutzen, verwenden, aufstellen, anziehen, tragen [Kleidung]
lagayat - postp. einschlie√ülich, zusammen mit
laghukatha - n. Kurzgeschichte
laghu-katha - n. Kurzgeschichte
lagnu - v.i. erscheinen, beginnen, anfangen
lagu - adj. berauschend, aufregend, erregend
lahad - n. Unterhaltung, Belustigung, Witz, Scherz wuÃànschen
lahar - n. Welle, Woge, KraÃàuselung, wellenfoÃàrmige Bewegung
lahari - n. Welle, Woge, KraÃàuselung, wellenfoÃàrmige Bewegung
laihernu - v.t. anprobieren[Kleidung]
laijanu - v.t. nehmen, wegtragen 
laj - n. Scham, Scheu
lajja - n. Schmach, Schande, Skandal
lakh - num. einhunderttausend, 1.00.000
lakkhan - adj. einhunderttausend, 1.00.000
laksha - adj. beabsichtigen , zielen
lakshmiprasaddevkota - n. Lakshmi Prasad Devkota [ein bedeutender nepalischer Dichter] 
lakshya - n. Ziel
lalitpur - n. Lalitpur, Patan [Nachbarstadt von Kathmandu]
lam - n. Reihe, lange Reihe, Schlange
lamai - n. LaÃànge
lamba - adj. lang
lamkanu - v.i. mit gro√üen Schritten gehen, streben 
lamkhutte - n. Moskito
lamo - adj. lang
lampasar - adj. ausgestreckt [mit HaÃànden und FuÃà√üen]
lamtann - adj. ausgestreckt [mit HaÃànden und FuÃà√üen]
lanchana - n. Stigma, Wunde, Verleundung, Beschuldigung
lanu - v.t. nehmen, wegnehmen
lapakka - adv. zugehoÃàrig, angegliedert n.
larbarinu - v.i. taumeln, schwanken
lash - n. Leichnam, Leiche
lasun - n. Knoblauch 
latanpatan - n. Verpackung 
lataramma - adj. gebuÃàndelt 
lato - adj. dumm
latti - n. Tritt
launu - v.t. anwenden, tragen [Kleidung]
lauro - n. Stock, Stab
lek - n. Bergregion, oberer Berghang
lekha - n. Prosa, Essay, Schrift, Artikel
lekhak - n. Schriftsteller, Autor
lekhinu - v.i. geschrieben werden
lekhnath paudyal - n. Lekh Nath Paudyal [ein bedeutender nepalischer Dichter]
lekhpadh - n. Lesen und Schreiben, Bildung, Erziehung
leninvad - n. Leninismus
lichhavi - n. Licchavi [eine fruÃàhe Herrscherdynastie im Kathmandutal] 
lichhavikal - n. Licchavi-Zeit
ligalige - n. ZaÃàpfchen [im Rachen] 
likhat - adj. geschrieben
likhit - adj. geschrieben
lila - n. Spiel, Unterhaltung, Liebesspiel
lilam - n. Versteigerung, Auktion
limbu - n. Limbu [eine nepalische Volksgruppe]
ling - n. Geschlecht [grammatisch] v.t. nehmen
lipi - n. Schrift, Alphabet
lobh - n. Versuchung, Verlockung, Gier, Habsucht, Begierde 
lobhi - adj. gierig
logne - n. Ehemann, Gatte
lognemanche - n. Mann
lognemanis - n. Mann
lohoto - n. ein kleiner metallener Wassertopf
lok - n. Welt, die drei Welten [Himmel, Erde, HoÃàlle], Volk
loktantra - n. Demokratie
luga - n. Kleidung, Kleider
luga dhunu - v.t. Kleider waschen
luga lagaunu - v.t. Kleider anziehen, sich anziehen
luga launu - v.t. Kleider anziehen, sich anziehen
luga phernu - v.t. Kleidung wechseln
luga phukalnu - v.t. Kleider ausziehen, sich ausziehen
luga phukaunu - v.t. Kleider ausziehen, sich ausziehen
luknu - v.i. sich verstecken 
lvang - n. GewuÃàrznelke 
lyaunu - v.t. bringen, holen postp. in, an, auf, unter 
macan - n. BuÃàhne
maccinu - v.i. schwingen, schaukeln n. Fisch
macha - v.t. fischen, angeln
madat linu - v.t. helfen, beistehen
madhes - n. das Tarai (Flachland im SuÃàden entlang der indischen Grenze) 
madhyanha - n. Mittag
madhyarat - adj. mittelalterlich n. Medium
madhyamik yug - n. Mittelalter
madhyanha - n. Mittag
madhyarat - n. Mitternacht
madhyavadhi nirvacan - n. vorzeitige Wahlen postp. in der Mitte, inmitten, in, zwischen, unter
mag - n. Forderung, Verlangen
magaj - n. Gehirn
magar - n. Magar [eine nepalische Volksgruppe]
magh - n. 10. Monat des nepalischen Kalenders [Januar/Februar]
magne - n. Bettler
magnu - v.t. bitten um
maha - n. Honig
mahadhiveshan - n. Generalversammlung
mahajan - n. Geldverleiher, Besitzender, reicher Mann 
mahakavi - n. gro√üer Poet
mahal - n. Palast
mahango - adj. teuer
mahasul - n. Zoll, ZollgebuÃàhr 
mahasus - n./adj. Geistesqual, erfahren, empfunden
mahatta - n. GroÃà√üe, Bedeutung
mahattva - n. GroÃà√üe, Bedeutung
mhattvakanksha - n. hohe Ambition
mahattvakankshi - adj. ehrgeizig, ambitioniert
mahattvapurna - adj. bedeutend, uÃàberlegen, uÃàberragend, hervorragend, stattlich, superb, koÃàniglich 
mahila - n. Frau
mahilo - n. ZweitaÃàltester [von BruÃàdern]
mahima -n. Ruhm, WuÃàrde, Hervorhebung
mahina - n. Monat
maida - n. Feinmehl
maidan - n. offenes Feld, Kampus
maiju - n. Mutters Bruders Ehefrau adj. schmutzig
mailo - n. ZweitaÃàltester [von BruÃàdern] 
main batti - n. Kerze
maina - n. Sammelname fuÃàr Vogelarten SuÃàd- und SuÃàdostasiens
maiyan - n. Prinzessin [auch benutzt zur Anrede einer Tochter]
maja- n. Freude, VergnuÃàgen, Spa√ü adj. erfreut, vergnuÃàgt, lustig
majha - n. Mitte, Zentrum
majhi - n. Majhi [eine Volksgruppe Nepals]
majhnu - v.t. saÃàubern, reinigen
makai - n. Mais
makal - n. ein kleiner beweglicher irdener Heizofen 
malai man parcha - comp. ich mag
malai man pardaina - comp. ich mag nicht 
malai thah chaina - comp. ich wei√ü nicht n. Malaysia
malilo - dj. fruchtbar
maltal - n. Ware, Dinge, Sachen
mama - n. Mutters Bruder
man - n. Denken, Geist, Verstand, Sinn, Empfinden, GefuÃàhl, Herz wuÃànschen, verlangen, begehren
manadeva - n. Manadeva [Name mehrerer nepalischer KoÃànige der Licchavi-Zeit]
manahi - n. Verbot, Kontrolle
manai - n. Verbot, Kontrolle
mananiya - adj. respektabel, ehrenhaft
manasib - adj. passend, geeignet
manaunu - v.t. feiern
manav - n. Mensch, Menschheit
manavshastra - n. Anthropologie, VoÃàlkerkunde 
manbodhak - adj. ehrend, hoÃàflich [grammatisch] 
manc - n. BuÃàhne, Forum
mancari - n. Spro√ü, Pflanzenspro√ü, SproÃà√üling
manche - n. Mensch, Person
mandro - n. gro√üe Bambus- oder Schilfmatte
mangal - n. Mars
mangalvar - n. Dienstag
mangg - n. Verlangen, Forderung
manglavar  - n. Dienstag 
mangshir - n. achter Monat des nepalischen Kalenders [November/Dezember]
mani - adj. respektvoll
manis - n. Mensch, Person
mannu - v.t. respektieren, achten,beachten, akzeptieren, anerkennen, verehren, in Ehren halten, annehmen, beobachten
manoranjan - n. Unterhaltung,Erholung, Belustigung
manovigyan - n. Psychologie
manovigyanik - adj. psychologisch
manparaunu - v.t. moÃàgen, bevorzugen n. Geisteszustand
mansthiti - n. Meinung, Ansicht, Kommentar 
mantralaya - n. Ministerium
mantri - n. Minister
manyata - n. Annahme, UnterstuÃàtzung, Anerkennung, Akkreditierung 
mapdanda - n. Standard
maramar - n. Kampf
marathi - n. Marathi
marg - n. achter Monat des nepalischen Kalenders [November/Dezember]
maric - n. schwarzer Pfeffer 
marka - n. Verlust, Schaden 
marnu - v.t. toÃàten, schlachten 
masala - n. GewuÃàrze
masauda - n. Entwurf,Skizze
masi - n. Tinte
masino - adj. klein, duÃànn, fein, weich 
mast - adj. berauscht, sorglos, ausgelassen
mastira - n./adv. Oberseite, oben
masu - n. Fleisch
mat - n. Ansicht, Meinung, Stimme, Dogma, Glaube
matabhed - n. Meinungsverschiedenheit, Meinungsunterschied
matako - adj. irden, aus Erde
matganana - n. StimmenauszaÃàhlung postp. oben
mathi - n. Obergescho√ü
matnu - v.i. betrunken werden 
mato - n. Meinung, Ansicht, UÃàbereinkunft
mato - n. Erde, Boden, Erdboden
matoko sarvekshan - n. Bodenerforschung
matribhakta - n. jemand, der seine Mutter verehrt
matribhasa - n. Muttersprache 
matriprem - n. Mutterliebe 
maulik - adj. original, echt 
mauna - n. Ruhe, Stille
mauri - n. Biene, Honigbiene
mausam - n. Wetter, Jahreszeit, Monsun 
mausami - adj. jahreszeitlich
mausuph - pron. persoÃànliche Anredeform fuÃàr den KoÃànig 
maya - n. Liebe
maya garnu - v.t. lieben
mece - n. Meche [eine Volksgruppe Nepals]
meghalaya - n. Meghalaya [ein nordostindischer Staat]
mehanat - n. BemuÃàhung, Anstrengung, harte Arbeit
mehel - n. eine Frucht
mel - n. Freundschaft, Beziehung, Vereinigung, Verbindung
meva - n. Melone 
midiya - n. Medien
mihi - adj. klein, duÃànn, weich, fein 
mihinet - n. flei√üig, Arbeit
mihineti - adj. arbeitsam, rege, flei√üig, geschaÃàftig
milaunu - v.t. anpassen, einfuÃàgen, vermischen
milnu - v.i. sich vermengen, sich vermischen, zusammenflie√üen, passen 
mirg - n. Rotwild
misaunu - v.t. mischen, vermischen, daruntermischen
misri - n. Kandiszucker
mit - n. Freund [besiegelt durch einen Eid]
mit lagaunu - v.t. Freundschaft schlie√üen [durch einen rituellen Eid]
mithai - n. SuÃà√üigkeiten
mitho - adj. lecker, schmackhaft 
miti - n. Frist, Datum, Tag
mohani - n. Zauber,Bezauberung, Zauberformel, BeschwoÃàrung 
mohi - n. Buttermilch
mohi parnu - v.t. Buttermilch machen 
moja - n. Socken
moren - n. MoraÃàne
mosam - n. Orange
motamoti - adj. annaÃàhernd, ungefaÃàhr
motar - n. Auto
motar haknu - v.t. ein Auto fahren
motaunu - v.i. fett werden, dick werden 
moto - adj. fett, dick
mrig - n. Rotwild
mrityu - n. Tod
mrityuko danda - n. Todesstrafe
muddha - n. Proze√ü, Fall, Rechtsfall 
mudki - n. Faustschlag

mudra - n. Siegel, MuÃànze, Geste 
mudrak - n. Drucker
mudrakshar - n. Drucktype
mudralaya - n. Druckerei
mudran - n. dasDrucken
muhan - n. Quelle eines Flusses oder eines BewaÃàsserungskanals
muhar - n. Fassade
muhurta - n. rechte Zeit, guÃànstiger Augenblick
mukam - n. Standort, Wohnsitz
mukh - n. Gesicht, Mund
mukh dhunu - v.t. das Gesicht waschen adv. hauptsaÃàchlich, in erster Linie, vor allem
mukta - adj. befreit, freigelassen
mukta garnu - v.t. befreien
mul - n. Wurzel, Ursprung, Quelle 
mula - n. Rettich
mulak - postp. basierend auf, abhaÃàngig von, gewachsen aus, hervorgegangen aus 
mulatah - adv. grundsaÃàtzlich
mulayat - adj. weich
mulsadak - n. Hauptstra√üe
muluk - n. Land, Reich, KoÃànigreich
mulvasi - n. Ureinwohner, erste Siedler 
mulya - n. Preis, Kosten, Wert
mulyangkan - n. Bewertung, EinschaÃàtzung, Auswertung
muma - n. Mama [nur innerhalb der Oberklasse]
munal - n. ein Gebirgsvogelart
mung - n. eine Linsenart
muni - postp. unter
muntira - postp. hinter, runter, nach unten 
musaldhare - adj. sintflutartig, heftig, stark [Regen] 
muskaunu - v.i. laÃàcheln 
muskuraunu - v.t. laÃàcheln,schimmern 
muso - n. Maus, Ratte
musoko dulo - n. Mauseloch
musuro - n. eine Linsenart
muthi - n. Faust
mutu - n. Herz, KernstuÃàck 
mvain - n. Ku√ü
mvain khanu - kuÃàssen 
myaun garnu - v.t. miauen
na - conj. weder, noch
nabbe - num. neunzig, 90
nacnu - n. Tanz, das Tanzen
nacnu - v.i. tanzen
nadi - n. Flu√ü
nagar - n. Stadt
nagarik - adj. buÃàrgerlich, BuÃàrger-
nagarik shastra - n. StaatsbuÃàrgerkunde
nagarpalika - n. Stadtverwaltung
nai - part. [Partikel zur Betonung des nachfolgenden Wortes] 
nain - interj. nein [ich mache es nicht]
naitikta - n. Moral, Ethik
naito - n. Nabel
najar - n. Sicht, Blick, Betrachtung 
najarana - n. Geschenk
najayaj - adj. ungeeignet
najik - adj. nahe, in der NaÃàhe [von] 
najitnu - v.t. nicht gewinnen, verlieren 
nak - n. Nase
nakka pora - n. NasenloÃàcher
nakkal - n. Kopie, Mode
nakhsha - n. Karte, Plan
nalikhutto - n. Schienbein
nam - n. Name, Substantiv, Nomen
namak -  adj. genannt, namens
namasthanik - adj. abhaÃàngig von einem Substantiv
namdar - adj. beruÃàhmt, bekannt, prominent
namkaran - n. Namengebung, Taufe n. Namengebung, Taufe 
namkarma - n. Name und Anschrift adj. spurlos
namyogi - n. Postposition
nanda - n. juÃàngere Schwester des Ehemanns
nandebhai - n. Ehemann der juÃàngeren Schwester des Ehemanns
nang - n. Nagel [an Hand oder Fu√ü] 
nangge - adj. unverhuÃàllt, nackt
nanggo - adj. unverhuÃàllt, nackt
nani - n. Kleinkind, Baby, kleines Kind
napunsakling - n. Neutrum [grammatisch]
nara - n. Slogan, Schlagwort 
naram - adj. weich
naramro - adj. schlecht
nardan - n. Nacken, Hals
narendra - n. KoÃànig
naresh - n. KoÃànig
nari - n. Handgelenk, Puls
narival - n. Kokosnu√ü
naso - n. Ader
naspati - n. Birne
nata - n. Verwandtschaft, BuÃàndnis, Allianz
natadar - n. Verwandte, Verwandter
nati - n. Enkel
natija - n. Ergebnis, Konsequenz 
natini - n. Enkelin
natishitosna - adj. gemaÃà√üigt [Klima]
nau - num. neun, 9
naun - n. Name
naun caleka - adj. beruÃàhmt
nauni - n. Butter
navaun - adj. neunte, neunter 
nayakatva - n. FuÃàhrung, Leitung, FuÃàhrerschaft, Hegemonie 
nayan - adj. neu
nebharo - n. Feige
nepalganj - n. Nepalganj [eine Stadt im westlichen Tarai]
nera - adj. nahe, in der NaÃàhe 
neri - adj. nahe, in der NaÃàhe 
neta - n. FuÃàhrer
netritva - n. FuÃàhrung, Leitung, FuÃàhrerschaft
nevar - n. Newar [eine Volksgruppe Nepals]
nibandha - n. Artikel, Beitrag, Essay, Dissertation
nibhnu - v.i. ausgeloÃàscht sein, getilgt sein, ausgehen
nivuwa - n. Zitrone
nico - adj. niedrig
bidaunu - v.i. schlafen gehen, schlaÃàfrig werden
nidhan - n./adj. Vernichtung, ZerstoÃàrung, Tod, arm
nidhar - n. Stirn
nidho - n. Entscheidung, letztes Wort adj. kinderlos
n. Vorwand, Entschuldigung 
niji kshetra - n. Privatsektor, privater Bereich
nikai - adj. viel, sehr viel
nikat - adj. nahe, in der NaÃàhe, eng, benachbart
nikaya - n. KoÃàrper, System
niko - adj. geheilt, in Ordnung
nilo - adj. blau
nimitta - n./postp. fuÃàr Ursache, Motiv, Anla√ü, Grund
nimnalikhit - adj. spaÃàter erwaÃàhnt, weiter unten erwaÃàhnt, folgend, unten genannt, nachfolgend 
nimti - postp. fuÃàr
ninda - n. Betrachtung, Verurteilung, Verdammung, Diffamierung, Verleumdung
nindan - n. Verleumdung, Verunglimpfung
niptara - n. Beseitigung, Erledigung 
nipun - adj. geschickt, faÃàhig
nir - adj. indigo
nira - adj. nahe, in der NaÃàhe
nirakaran - n. Abschaffung, Aufhebung, Annullierung
nirakshar - adj. des Schreibens und Lesens unkundig, ungebildet
nirantar - adj. unaufhoÃàrlich, konstant, fortlaufend, ununterbrochen, unablaÃàssig, staÃàndig
nirantarta - n. KontinuitaÃàt, Andauer, Fortdauern
niraparadh - adj. unschuldig, schuldlos
nirarthak - n. bedeutungslos, sinnlos, vergeblich, nutzlos, unsinnig
nirdaya - adj. erbarmungslos, unbarmherzig, grausam
nirdayata - n. Erbarmungslosigkeit, Grausamkeit
nirdesh - n. Anordnung, Befehl, Instruktion, Anweisung
nirdeshak - n. Direktor
nideshan - n. Anordnung,Befehl, Instruktion, Anweisung
nirman - n. Konstruktion, Formation, Entwurf, Aufbau, Formung, Bildung, Errichtung, Schaffung
nirmata - n. Produzent,Hersteller 
nirmit - adj. gemacht, hergestellt
nirnaya - n. Entscheidung, LoÃàsung, KlaÃàrung, Beschlu√ü, Resolution
nirogi - adj. gesund
nirvacan - n. Wahl, Abstimmung
nis - n. Gneis
nisedh bhumi - n. verbotenes Land
nishcal - adj. unbeweglich, fest, standhaft
nishcaya - n. sicheres Wissen, gesicherte Kenntnis, Resolution, Beschlu√ü, Vertrauen
niscit - adj. sicher, zweifellos, unfehlbar, zweifelsohne, ohne Zweifel
nishcit - n. definitives Zahlwort
niskantak - adj. sorglos, problemlos
niskanu - v.i. herauskommen, hinausgehen, erscheinen, entspringen
nisto - adj. einfach, schlicht, mild, sanft
nitamba - n. HuÃàfte
niti - n. Politik, Moral
niun - n. Vorwand, Ausflucht, Entschuldigung
nivaran - n. Vermeidung, VerhuÃàtung
nivas - n. Heim, Wohnsitz, Residenz 
nivasi - n. Bewohner, Einwohner
niyam - n. Regel, Gesetz, Regulierung, Gebrauch, Brauch
niyantran - n. Kontrolle
niyati - n. Selbstkontrolle, Beherrschung, Selbstbeherrschung 
niyukta - adj. ernannt
niyuktti - n. Ernennung, Nominierung 
niyutta - adj. ern annt, angestellt
nokar - n. Diener
nuhaune kotha - n. Badezimmer
nuhaunu - v.t. baden, ein Bad nehmen
nun - n. Salz
nunilo - adj. salzig
nyauri - n. Mungo
nyaya - n. Gerechtigkeit, Recht n. Richter
nyayadhish - n. Richter
nyayadhish - n. Gericht, Gerichtshof 
nyayapalikta - n. Judikative, Justiz, Justizwesen 
nyuntam - adj. minimal
ochyan - n. Bett, Bettzeug, Schlafmatte 
ochyaunu - v.t. das Bettzeug ausbreiten
odhaunu - v.t. jemanden ankleiden
odhne - n. Decke, Bettuch bedecken
odhnu - v.i./v.t. sich anziehen, sich ankleiden; einpacken,
ogatnu - v.t. besetzen, in Anspruch nehmen
ohar dohar - n. das Kommen und Gehen 
ohor dohor - n. das Kommen und Gehen 
ohralnu - v.t. herabsteigen lassen
oilaunu - v.i. verwelken
oilinu - v.t. verwelkt sein, verdorrt sein 
oiraunu - v.i. tropfen, niederfallen
oirinu - v.t. tropfen lassen, fallen lassen [in gro√üer Menge]
oirini - v.i. tropfen, fallen [in gro√üer Menge]
oirinu - v.i. ununterbrochen flie√üen
ojhel - adj. versteckt, verborgen, abgeschirmt
okatnu - v.t. besetzen, reservieren n. Walnu√ü
okhati - n. Arznei, Medizin
oralnu - v.i. herunterkommen,herabsteigen
orlinu - v.i. herunterkommen, herabsteigen
osarinu - v.i. von einer Stelle zur anderen bewegt werden
osarnu - v.t. etwas von einer Stelle zur anderen bewegen
oth - n. Lippe
pacadi - postp. hinter
pacas - num. fuÃànfzig, 50
pacadi - num. fuÃànfundachtzig, 85 
pacchim - n. Westen
paccis - num. fuÃànfundzwanzig, 25 
pachi - postp. nach, spaÃàter, hinter 
pachattar - num. fuÃànfundsiebzig, 75 
pachaute - adj. spaÃàt, ruÃàckstaÃàndig 
pachi - postp. nach [zeitl.], nachher, spaÃàter, hinter
pachi hatnu - v.i. sich zuruÃàckbewegen, sich zuruÃàckziehen
pachi janu - v.i. hinterhergehen, folgen 
pachi sarnu - v.i. zuruÃàcktreten
pachillo - adj. letzter, hinterster
pachi pachi - adv. sofort nach, unmittelbar hinter, direkt hinter 
pacpanna - num. fuÃànfundfuÃànfzig, 55
pad - n. Fu√ü, Schritt, Fu√üschritt
padadhikari - n. Amtsinhaber, AmtstraÃàger, WuÃàrdentraÃàger
padartha - n. Bedeutung [eines Wortes], Ursache, Anla√ü
padarthavacak nam - n. Sachbegriff
padavi - n. Titel, Bezeichnung, Attribut 
padai - n. Studien, Hausaufgaben 
padhaunu - v.t. lehren, unterrichten
padhelekheka  - adj. gebildet, des Lesens und Schreibens kundig
padhnu - v.t. lesen, lernen, studieren
padina - n. Minze
pagal  - n. VerruÃàckter 
pagalkhana - n. Irrenhouse
pagalnu - v.t. schmelzen, zum Schmelzen bringen
pagalnu - v.i. schmelzen
pahad - n. Berg, Bergland 
pahadi pardesh - n. Bergland
pahenlo - adj. gelb
pahican - n. Bekanntschaft, Anerkennung, IdentitaÃàt 
pahilo - adj. erste, erster
pahiran - n. KostuÃàm, Kleid, Gewand 
pahuna - n. Besucher, Gast
painsathhi - num. fuÃànfundsechzig, 65 
paintalis - num. fuÃànfundvierzig, 45
paintis - num. fuÃànfunddrei√üig, 35
paitalo - n. Sohle
pajani - n. Arrangement, UÃàberholung [das jaÃàhrliche Fest, bei dem die RegierungsaÃàmter fuÃàr das kommende Jahr neu vergeben oder erneuert wurden]
pakaunu - v.t. kochen [Esssen] 
pakeko - adj. reif, gar, gekocht 
paket - n. Tasche
pakhala - n. DiarrhoÃàe, Duchfall 
pakhalnu - v.t. spuÃàlen
pakheta - n. FluÃàgel
pakhura - n. Arm
pakka - adj. 1. sicher,gewi√ü,wahr; dauerhaft, stark; sorgfaÃàltig, erfahren
pakka garnu - v.t. bestaÃàtigen, sicher machen
pakku - n. in Butter gebratenes Fleisch
paknu - v.i. reifen, reif sein, gekocht sein
pako - adj. bejahrt, erfahren
pakranu - v.t. fangen, halten, gefangennehmen
pakrau - n. Verhaftung, Ergreifung, Gefangennahme, Inhaftierung, Arrest
paksha - n. Teil, FluÃàgel, Partei
palnu - v.t. sich sorgen um, sich kuÃàmmern um, aufziehen, ernaÃàhren, zuÃàchten halten (Tiere)
palpa - . Palpa [einstiger Kleinstaat, heute Distrikt Nepals]
paltan - n. Regiment, Battalion 
palunggo - n.  Spinat
pan - n. ein Betelnu√üblatt 
pana - n. Buchseite 
panati - n. Urgro√üenkel
panc - num. fuÃànf, 5
panc patra - adj. fuÃànffach [bei GegenstaÃànden]
pancanabbe - num. fuÃànfundneunzig, 95 
pancangga - Almanach, Kalender 
pancaun - num. fuÃànfte, fuÃànfter
pancayat - n. Rat (1961-1990 Verwaltungseinheit auf Dorf-, Distrikt- und Nationalebene sowie das jeweilige Einzugsgebiet)
panchaunu - v.t. ausweichen, entkommen, zur Seite sto√üen
pandhra - num. fuÃànfzehn, 15
pani - adv. auch, sogar 
pani - n. Wasser, Regen 
pani..pani - adv. sowohl ... als auch 
pani pareko vela -  comp. wenn es regnet 
pani parnu - v.t. regnen
paniun - n. flacher LoÃàffel zum SchoÃàpfen von Reis
panjaa - Handschuhe; Krallen 
panjika - n. Almanach, Kalender 
pankha - n. FluÃàgel, Feder; AnhaÃànger 
pantha - n.  1 Pfad (fig.); Sekte
panthi - n. FluÃàgel (politisch) 
pap - n. SuÃànde  
papi - adj. suÃàndhaft, verwerflich, lasterhaft, kriminell
par - n. Befreiung, ErloÃàsung 
para - adv. neben, getrennt, hinter 
paraghaun - adv. uÃàbernaÃàchstes Jahr
parajaya - n. Niederlage
parajit - adj. besiegt, uÃàberwunden 
parajit - adj. bezwungen, besiegt, uÃàberwunden
parakram - n. Macht, StaÃàrke, Tapferkeit
parakrami - adj. heroisch, heldenhaft, tapfer, stattlich
param - adj. excellent, bester, Haupt-
paramdham - n. Himmel, Paradies, gesegnetes Land
paramgati - n. Befreiung, ErloÃàsung, ewiges Heil
parampad  - n. Befreiung, ErloÃàsung, ewiges Heil
parampara - n. Folge, Reihenfolge, Ordnung
paramparagat - adj. traditionell
paramparik - adj. traditionell, geerbt, ererbt 
parampita - n. der AllmaÃàchtige
parantu - n./adv. aber, trotz, jedoch, restliches Leben, Ende
parapacuke - n. Scheidung, EheaufloÃàsung
parar - adv. vorletztes Jahr, vor zwei Jahren
pararastra - n. auswaÃàrtiger Staat, Ausland 
pararastra mantralaya - n. Au√üenministerium
pararastra mantri - n. Au√üenminister
pararastriya - adj. fremd, auswaÃàrtig, auslaÃàndisch
parspar - adj. gegenseitig, einander
parca - n. Blatt, Flugblatt
parda - n. Vorhang, Schirm, Schleier 
pardabhitrai - comp. im Verborgenen
pardesh - adv. im Ausland, ins Ausland ins Ausland gehen
pardesh lagnu - ins Ausland gehen
parela - n. Augenlid
pareva - n. [junge] Taube
pari - n. die andere Seite [einer KuÃàste oder Grenze]
pari - n. die andere Seite [einer KuÃàste oder Grenze]
paribhasa - n. Definition, Terminologie n. Mobilisierung
paricalan - n. Kenntnis, Bekanntschaft, EinfuÃàhrung
parichhed - n. Paragraph, Teil
pariksha - n. Untersuchung, Forschung 
parikshan - n. Untersuchung, Forschung 
parimanbodhak - adj. quantitativ [grammatisch] 
parimanbodhak - n. Ergebnis, Folge, Konsequenz
parinamsvarup - conj. infolgedessen, folglich
parinati - n. Umformung, Transformation
paripati - n. Tradition, Methode, Arrangement, Ordnung
paripurti - n. Abschlu√ü, VervollstaÃàndigung
parisad - n. Versammlung, Rat, Senat, Vorstand, Komitee
parishist - n. Anhang
parishrami - adj. eifrig, flei√üig
paristhiti - n. Beschaffenheit, Kondition, Umgebung, Bedingung, Umstand, Situation
parit - adj. beschlossen
parityag - n. Aufgabe, Verzicht, Preisgabe
parivar - n. Familie
parivartan - n. Austausch, Wechsel, UÃàbergang, UÃàbertragung
pariyojana - n. Projekt
parkhal - n. Wand, Au√üenwand 
parkhanu - v.t. warten auf, erwarten, Geduld haben [mit]
parkhinu - v.t. warten auf, erwarten, Geduld haben [mit]
parnu -  v.i. geschehen, sich ereignen, fallen unter, gehoÃàren zu
parnu - v.t. machen, legen, verursachen, bewirken
paro - n. Queck silber
parsi - adv. uÃàbermorgen
parti - n. Partei
parti kendriya kamiti - n. Parteizentralkomitee 
parva - n. Fest, FeÃÇte, Kapitel, Abschnitt, Teil, Sektion
parvat - n. Parvat [einstiger Kleinstaat, heute Distrikt Nepals]
paryanta - postp. bis zu, bis
paryatak - n. Reisender,Wanderer, Tourist
paryatakharuko svarg - n. Touristenparadies
paryatan - n. das Reisen, Tourismus
pasal - n. GeschaÃàft, Laden
pasale - n. Ladenbesitzer, Kaufmann, VerkaÃàufer 
paschim - n. Westen
pashupalan - n. Tierzucht, Viehzucht 
pashupati - n. Pashupati
pasina - n. Schwei√ü
paskanu - v.t. servieren [Speisen], auftischen
pasnu - v.t. betreten, hineingehen, hereinkommen, kommen nach 
pat - n. Jute
patak - n. Mal, Gelegenheit
patalo - adj. duÃànn, schlank
patan - n. Verpackung
patan - n. Fall, Niedergang, Abstieg, Degradierung, Absetzung
patan - n. Lalitpur, Patan [Nachbarstadt von Kathmandu] n. BewaÃàsserung
path - n. Lektion, UÃàbung 
path - n. Pfad, Kurs
pathaunu - v.t. schicken, senden, abschicken, wegschicken
pathi - n. Lamm [weiblich]
patho - n. Lamm [maÃànnlich]
pathshala - n. Schule, Seminar
pathshalaya - n. Schule, College, Akademie, Seminar
pati - n. Ehemann, Gatte
patit - adj. gefallen, degradiert, kastenlos, aus der Kaste ausgeschlossen 
patni - n. Ehefrau, Gattin
patra - n. Seite
patrakar - n. Journalist, Reporter 
patre cattan - n. Sedimentgestein
patrika - n. Magazin, Journal, Zeitschrift
patta - n. Blatt, Folie, Adresse, Art, Klasse, quadratische Figur
patthar - n. Stein
patti - n. Verband, Bandage
patti - n. Seite
pattyaunu - v.t. falten, flechten
pau - n. ein Viertel
paune - adj. Viertel vor [bei Uhrzeiten] 
paunu - v.t. erhalten, bekommen
pauranik - adj. legendaÃàr
pauranu - v.i. schwimmen
pauri - n. Schwimmen
pauri khelnu - v.t. schwimmen
pauroti - n. Brot
paus - n. neunter Monat des nepalischen Kalenders [Dezember/Januar] 
paustik - n. ErnaÃàhrung
pesh - postp. vor
pesha - n. Beruf, BeschaÃàftigung 
pesta - n. Pistazie

pet - n. Magen, Bauch
peti - n. Gurtel, Kassette, erhoÃàhte Plattform um ein Haus, BuÃàrgersteig
phagun - n. elfter Monat des nepalischen Kalenders [Februar/MaÃàrz] 
phaida - n. Vorteil, Gewinn
phailanu - v.i. sich erstrecken
phailanu - v.i. sich ausbreiten, sich verbreiten, sich erstrecken, verbreitet sein
phailinu - v.i. sich ausbreiten, sich verbreiten
phaisala - n. Entscheidung 
phalam - n. Eisen
phalgun - n. elfterMonatdes nepalischen Kalenders [Februar/MaÃàrz]
phalnu - v.t. wegwerfen
phalnu - v.i. FruÃàchte tragen, Obst anbauen, Obst von BaÃàumen bekommen; schaÃàlen, reinigen, enthuÃàlsen
phalphul - n. FruÃàchte und Blumen 
phalphul kheti - n. Gartenbau
phalsvarup - postp. als ein Ergebnis von 
phansi - n. Hinrichtung durch ErhaÃàngen 
phapar - n. Buchweizen
pharak - n. Unterschied, Trennung
pharakilo - adj. breit, geraÃàumig, ausgedehnt, weitraÃàumig
pharar - n. GeaÃàchteter, FluÃàchtling, Deserteur
pharkanu - v.i. zuruÃàckkehren
pharsi - n. KuÃàrbis [gro√üer, gelber] 
phatsaunu - v.t. entwickeln
phatyangro - n. Grille, GrashuÃàpfer
pherabadal - n. Wechsel, VeraÃànderung, Modifikation
pheri - adv. wieder, wiederum, zusaÃàtzlich
phesan - n. Mode
phijinu - v.i. sich ausbreiten, sich verbreiten, sich erstrecken, verbreitet sein
phikri  garnu - v.t. sich Sorgen machen, sich sorgen
phila - n. Schenkel
philipins - n. Philippines
phohor - adj. schmutzig, dreckig 
phokso - n. Lunge
phranseli - adj. franzoÃàsisch
phul - n. Blume
phul - n. Ei
phulbari - n. Blumengarten
phuleko kesh - graues Haar 
phulkopi - n. Blumenkohl
phupaju - n. Vaters Schwesters Ehemann
phupu - n. Vaters Schwester
phurtilo - adj. schick, klever, schlau, raffiniert
phusro - adj. grau, wei√ühaarig 
phutbal khelnu - v.t. Fu√üball spielen 
phyanknu - v.t. wegwerfen
phyauro - n. Fuchs
pidit - adj. geplagt, bedruÃàckt, bekuÃàmmert
pindalu - n. eine Wurzelart
pindulo - n. Wadenbein
ping - n. Schaukel
pir - n. Sorge, Kummer, Angst
pira - n. Bodensitz [aus Stroh oder Holz]
piralnu - v.i./v.t. Probleme bereiten, aÃàrgern, quaÃàlen
piro - adj. scharf [gewuÃàrzt]
pirolnu - v.t. Probleme bereiten, aÃàrgern, quaÃàlen, Schmerzen zufuÃàgen
pita - n. Vater [sanskritisiert]
pithiun - n. RuÃàcken
pitho - n. Mehl, Pulver
pitho - n. Mehl
pittal - n. Messing
pohor - adv. voriges Jahr, letztes Jahr 
poi - n. Ehemann
poila - n. das Weglaufen mit einem Mann vor oder ohne formalle Heirat
poila janu - comp. mit einem Mann davonrennen
pokhari - n. See,Teich
poleko masu - n. gegrilltes Fleisch 
pothi mujur - n. Truthenne
potnu - v.t. mit rotem Lehm beschmieren, die Wand streichen, tuÃànchen
poto - n. Schmiere, Schmierlappen
prabandhak - n. Manager, Essayschreiber, Essayist
prabhat - n. DaÃàmmerung, Tagesanbruch
prabhav - n. Einflu√ü, Macht, StaÃàrke, AutoritaÃàt, Dominanz
prabhavashali - adj. maÃàchtig, stark, einflu√üreich
pracalan - n. Brauch, Gebrauch, Sitte, Umlauf, Vorherrschen, Bewegung
pracalit - adj. im Brauch, vorherrschend
pracar - n. VeroÃàffentlichung, Publikation, Anzeige, AnkuÃàndigung
pracarit - adj. publiziert, verbreitet, propagiert, in Umlauf gesetzt 
pracing - adj. alt, antik
pracinta - n. hohes Alter, Altertum, klassisches Altertum
pradesh - n. Region, Gebiet, Provinz 
pradeshik - adj. regional
pradanmantri - n. Premierminister
pradhannyayadhish - n. Oberster Richter
pradhyapak - n. Lektor,Dozent
pradurbhav- n. Manifestation,Geburt, Beginn
pradusan - n. Verschmutzung, Verunreinigung
pragati - n. Fortschritt, Verbesserung, Entwicklung
pragatishil - adj. fortschrittlich, modern, progressiv
prahari - n. Polizei
praja - n. Volk, Untertane
prajatantra - n. Demokratie
prajantantrik - adj. demokratisch
prakar - n. Art,Weise,Sorte
prakash - n. Licht, Manifestation,Publikation 
prakashak - n. Herausgeber
prakashan - n. Publikation, VeroÃàffentlichung
prakashit - adj. veroÃàffentlicht, publiziert
prakashkiya - adj. aufdenHareuasgeber bezogen
prakhyat - adj. beruÃàhmt, gefeiert
prakriti - n. Natur,Veranlagung 
prakritik - adj. natuÃàrlich, physikalisch, materiell 
parkritik gyas - n. Naturgas
prakritik vanaspati - n. natuÃàrliche Vegetation
prakriya - n. Kapitel, Abschnitt [eines Buches]
praman - n. Beweis, Nachweis, Wahrheit
pramanik - adj. autentisch, autoritativ, zuverlaÃàssig, nachgewiesen
pramnit - adj. bewiesen, erwiesen, nachgewiesen
pramanpatra - n. Zertifikat, Urkunde, Erlaubnisschreiben
pramukh - n. Leiter, Vorsteher, Ober-
pranali - n. System, Weg, Sitte, Brauchtum
pranta - n. Provinz, Grenze, Ende
prapta - adj. erhalten, bekommen, erreicht, erlangt
prapti - n. Aufnahme, Annahme, Empfang, Vollmacht, Einkommen, Verdienst 
prarambha - n. Anfang, Beginn
prarthana - n. Bitte,Gebet
prarthana garnu - v.t. beten, flehentlich bitten
prasanga - n. Zusammenhang, Kontext, Verbindung 
prasar - n. Verbreitung
prashangsa - n. Lob,Preis, Beifall
prashasan - n. Verwaltung,Administration 
prashasta - adj. reichlich,genug, ausreichend, [sehr] viel 
prashna - n. Frage, Problem
prashnarthak - n. Interrogativpronomen
prashnavali - n. Fragebogen
prasiddha - adj. bekannt, beruÃàhmt
prastav - n. EinfuÃàhrung, Einleitung, Vorschlag
prastavana - n. EinfuÃàhrung, Einleitung, Vorschlag
prastut - adj. praÃàsentiert, erklaÃàrt, gesagt 
pratam purusvacak - n. 1. Person [grammatisch] 
pratha - n. Brauch, Sitte, Gebrauch, Praxis, Methode, System 
pratham - adj. erster
pratham purus - n. erste Person [grammatisch] 
prathamikta - n. PrioritaÃàt
prati - postp. pro, in Bezug auf, gegenuÃàber 
pratibaddha - adj. engagiert
pratibahhdata - n. Engagement, Verpflichtung 
pratibandhit - adj. verboten, verbannt
pratibha - n. Genie,Talent
pratibimbha - n. Spiegelung, Bild, Schatten 
pratibimbit - adj. reflektiert
pratigama - adj. ruÃàckschrittlich, ruÃàcklaufig 
pratik - n. Symbol, Fetisch
pratikar - n. Vergeltung,Rache
pratikatmak - adj. symbolisch,allegorisch 
pratikriya - n. Reaktion
pratiksha - n. Erwartung
pratinidhi - n. Vertreter, Ersatz, RepraÃàsentant
pratinidhitva - n. RepraÃàsentation, Deputation, Vertretung
pratipaksha - n. Opposition, Gegenseite
pratipakshi - n. Gegner,Rivale,Kontahent, Mitbewerber
pratishat - n. Prozent, %
pratishodh - n. Rache
pratisparddha - n. RivalitaÃàt,Wettstreit
prativedan - n. Bericht,RepraÃàsentation n. Wettbewerb,RivalitaÃàt 
pratyek - adj. jeder
pravacan - n. Kommentar, ErlaÃàuterung 
pravesh - n. Zugang,Zutritt,Eintritt, Eingang 
pravidhi - n. Technik
pravidhigya - n. Techniker
pravriti - n. Trend
pravriti - n. Neidung, Tendenz 
prayah - adv. fast, beinahe, oft
prayas - n. Versuch, BemuÃàhung, Anstrengung
prayog - n. Versuch, BemuÃàhung
prayog - n. Nutzung, Anwendung, Gebrauch, Verwendung
pret - n. Totengeist, boÃàser Geist
pristhabhumi - n. Basis, Grundlage 
prithvi - n. Erde
priya - adj. lieb, teuer, geliebt 
puchhar - n. Schwanz
pugnu - v.i. genuÃàgen, ausreichen, ankommen
puga garnu - v.t. opfern, verehren, anbeten
puja kotha - n. Gebetsraum, Andachtsraum
punargathan - n. Reorganisation
punarjivit - adj. wiederbelebt, auferstanden Rekonstruktion, Wiederaufbau
punarvalikan - n. Revision,RuÃàckblick
punarvas - n. Rehabilitation
puniun - n. flacher LoÃàffel zum SchoÃàpfen von Reis
punling - n. Maskulinum [grammatisch]
pura - adj. vollstaÃàndig, ganz, voÃàllig 
purano - adj. alt
purashcaran - n. AusfuÃàhren von Feueropfer oder religioÃàsem Opfer, Wiederholen des Namens der Gottheit zu einem bestimmten Zweck
purashcaryan - n. AusfuÃàhren von Feueropfer oder religioÃàsem Opfer, Wiederholen des Namens der Gottheit zu einem bestimmten Zweck
puratatva - n. ArchaÃàologie
puri - n. in Butter gebackenes Brot 
purkha - n. Vorfahr, Ahne
purna- adj. vollstaÃàndig, ganz, voÃàllig 
purnatah - adv. voÃàllig, vollstaÃàndig, ganz 
purnataya - adj. voÃàllig,vollstaÃàndig
purnima - n. Vollmondtag, letzter Tag der hellen MonatshaÃàlfte 
purohit - n. Familienpriester
purusartha - n. Anstrengung, Energie, Mut, Tapferkeit
purusvacak sarvanam - n. Personalpronomen 
purvadhar - n. Infrastruktur
purvagraha - n. Vorurteil
purvak - psuff. mit
purvi - adj. oÃàstlich, Ost-
purviya - adj. oÃàstlich, Ost-
puryaunu - v.t. fuÃàhren, hinfuÃàhren, einen Wunsch erfuÃàllen
pus - n. Monat des nepalischen Kalenders [Dezember/Januar]
pusta - n. Generation, Nachfolge
pustakalaya - n. Bibliothek,BuÃàcherei
pusti - n. Lebensunterhalt, Nahrung 
putali - n. Schmetterling
pval - n. OÃàffnung, Loch
pyaj - n. Zwiebel
pyaro - adj. lieb, teuer
pyau - n. Pilz
racak - n. Autor, Schriftsteller, Komponist
racana - n. Struktur, Aufbau, Zusammensetzung, Komposition, Errichtung, Konstruktion
racanatmak - adj. konstruktiv, strukturell, tektonisch
racayita - n. Autor, Schriftsteller, Komponist
racit - adj. gemacht, hergestellt 
radhi - n. grober Wollteppich 
ragat - n. Blut 
ragat aaunu - bluten
rahanu - v.i. verweilen, wohnen, warten, uÃàbrigbleiben
rahar - n. eine Linsenart
rahasyamaya - adj. mysterioÃàs, geheimnisvoll 
rahasyamaya dhangabta - adv. auf mysterioÃàse Weise
rahat - n. Annehmlichkeit, Komfort, Erleichterung
rai - n. Rai [eine Volksgruppe Nepals]
raithane - n. Ureinwohner
raiti - n. PaÃàchter, StaatsbuÃàrger, Untertan
raja - n. KoÃànig, Herrscher
rajaharuma - comp. unter den KoÃànigen, zwischen den KoÃànigen
rajasva - n. Steuer, GebuÃàhr 
rajdarbar - n. KoÃànigspalast
rajdhani - n. Hauptstadt
rajdut - n. Botschafter
rajdutavas - n. Botschaft
rajhans - n. Schwan
raji - adj. bereit, willig, gewillt
rajikhusi - n. Bereitwilligkeit,freudiger Empfang
rajinama - n. Kompromi√übeschlu√ü, Kompromi√üangebot
rajkaj - n. Verwaltung, Regierungsarbeit
rajkaji - adj. die Regierung oder Verwaltung betreffend, Regierungs-, Verwaltungs- 
rajkanya - n. KoÃànigstochter, Prinzessin
rajkarya - n. Verwaltung, Regierungsarbeit
rajkumar - n. Prinz
rajkumari - n. Prinzessin, KoÃànigstochter 
rajnaitik - adj. politisch
rajnaitik gatividhi - politische Bewegung
rajniti - n. Politik, Politikwissenschaft
rajnitigya - n. Politiker, Staatsmann 
rajnitik - adj. politisch
rajnitik labh - n. politische Bedeutung 
rajparisad - n. Staatsrat
rajprasad - n. Palast
rajtantra - n. Monarchie, KoÃànigtum
rajvanshi - n. Rajvanshi [eine Volksgruppe Nepals]
rajya - n. KoÃànigreich, Staat, Staatsgebiet, Territorium
rajyadhikar - n. Staatsmacht
rajyavati - n. Rajyavati [Name der Mutter von Manadeva I.]
rakhnu - v.t. tun, stellen, setzen, legen, halten, erhalten, bewahren, behalten, schuÃàtzen, aufbewahren, zuruÃàcklegen
raksha - n. Verteidigung, Schutz, Bewachung
raksi - n. alkoholisches GetraÃànk, Schnaps, Branntwein
raktapurna - adj. blutig
rajkumari - n. Prinzessin
ramailo - adj. erfreut, erfreulich
ramaunu - v.i. erfreut sein, gluÃàcklich sein, tief bewegt sein
ramnu - v.i. erfreut sein, gluÃàcklich sein, tief bewegt sein
ramro - adj. lieblich, reizend, schoÃàn 
rang - n. Farbe
rangamanc - n. BuÃàhne
rangaunu - v.t. faÃàrben, anstreichen 
rangicangi - adj. vielfarbig, bunt
rangin - adj. farbig, bunt
rango - n. WasserbuÃàffel [maÃànnlich] 
rani - n. KoÃànigin
ranniti - n. Strategie
rap - n. Sonnenhitze
ras - n. Saft, BruÃàhe
rasiya - n. Ru√üland
rastra - n. Nation
rastrabhasa - n. Nationalsprache
rastranayak - n. StaatsfuÃàhrer, Staatsoberhaupt 
rastravad - n. Nationalismus

rastravadi - n./adj. Nationalist, nationalistisch
rastriya - adj. national 
rastriya jagaran - nationales Erwachen 
rastriya rastra -  Nationenstaat
rastriyata - n. NationalitaÃàt, Nationalismus
rat - n. Nacht
rat - postp. gewidmet, beigefuÃàgt
rat parcha - es wird Nacht, es wird dunkel
rati - adv. nachts, in der Nacht, bei Nacht
rato - adj. rot
rato mato - n. roter Lehm zum Streichen der WaÃànde
raun - n. KoÃàrperhaar
ravivar - n. Sonntag
rayako sag - n. SenfblaÃàtter (gro√ü)
rel - n. Eisenbahn
rica - n. Vers, Hymne
rihai - n. Freilassung, Befreiung
rijha - n. GluÃàck, Freude, ErfuÃàllung 
rina - n. Schuld, Verpflichtung
rini - n./adj. Schuldner; verschuldet
ris - n. AÃàrger, Zorn
risaeko - adj. boÃàse, aÃàrgerlich, veraÃàrgert
risaunu - v.i. sich aÃàrgern, veraÃàrgert sein
risi - n. Weiser, Heiliger, Asket
riti-thiti - n. soziale BraÃàuche
rittinu - v.i. leer sein
ritto - adj. leer, hohl
ritu - n. Jahreszeit
rodh - n. Blockierung, Versperrung, Behinderung
rog - n. Krankheit, Leiden
rogi - n. Kranker
rojgar - n. GeschaÃàft,Handel,Beruf
rok -  n. Verbot, Untersagung, Restriktion, BeschraÃànkung
rokinu - v.i. angehalten werden, aufgehalten werden
roknu - v.t. verbieten, untersagen, anhalten, aufhalten, stoppen, zum Stillstand bringen
roti - n. Brot [aus Mehl und Wasser, aber ohne Hefe]
ruci - n. Interesse, Gefallen, Geschmack
rugha - n. ErkaÃàltung
rugna - adj. krank, indisponiert, unwohl sich zum Weinen fuÃàhlen
runu - v.i. weinen, schreien, lamentieren
rup - n. Form, Aussehen, Erscheinung, SchoÃànheit
rupantar - n. Transformation, Umwandlung, Umgestaltung, Umformung, UÃàbertragung, Konversion, Metamorphose
rupi - postp. in der Form von
rupiyan - n. Rupie
ruvanda - n. Ruanda
ruvaunu - v.i. zum Weinen bringen 
sabai - adj. alle, alles von allen [zur Konstruktion des Superlativ]
sabai bhanda - pron. fast alle, fast jeder 
saber - adj. fruÃàh
saberai - adv. fruÃàh
sabha  - n. Versammlung, Treffen
sabhapati - n. Vorsitzender [einer Versammlung, Organisation oder Partei]
sabhyata - n. Zivilisation, HoÃàflichkeit, gutes Verhalten
sabik - adj. fruÃàher, ehemalig n. Seife
sabunko gaj - n. Seifenschaum
sabunko phinja - n. Seifenschaum
sabut - n. Beweis, Nachweis, Wahrheit
sacetak - n. Einpeitscher, GeschaÃàftsfuÃàhrer
saciv - n- SekretaÃàr, Berater, VerbuÃàndeter, Begleiter
sacivalaya - n. Sekretariat Stra√üe [befestigt]
sadan - n. Residenz, Haus, Versammlungshalle
sadar - n. Hauptstadt, Hauptort, Regierungssitz, Verwaltungssitz
sadar upatyaka - n. Zentraltal Mitglied
sadashyaharuprati - UnterdruÃàckungspolitik gegenuÃàber den Mitgliedern  
sadasya - n. Mitglied
sadasyata - n. Mitgliedschaft
sadbhavana - n. Freundschaft
sadhain - adv. immer
dashan - n. Material, Mittel, Ressource, Quelle
sadhan - n. DurchfuÃàhrung, AusfuÃàhrung
sadharan - adj. einfach, schlicht, allgemein, generell
sadharan sabha - n. Generalversammlung
sadhe - adj. halb nach [bei Uhrzeiten] 
sadichha - n. guter Wille
sadupayog - n. Nutzung, Nutzbarmachung 
sadyantra - n. VerschwoÃàrung,Intrige
sagpat - n. BlattgemuÃàse
sagar - n. Ozean, die See, Verbrennungsplatz 
sagar - n. Himmel, Firmament
sagarkhand - n. SuÃà√ükartoffel
sagarmatha - n. Sagarmatha, Chomolungma, Mount Everest
sagaunu - v.t. helfen, beistehen
saghaunu  - v.t. helfen, beistehen
sagio - adj. ganz, vollstaÃàndig, ungeteilt n. GemuÃàse
sagsabji - n. Partner, Komplize
sahabhagita - n. Teilnahme, Beteiligung
sahalekhak - n. Mitautor
sahamat - n./adv. UÃàbereinstimmung, UÃàbereinkunft, ein und derselben Meinung
sahamati - n. UÃàbereinkunft, Abkommen
sahan - n. Ausdauer
sahanu - v.t. aushalten, ertragen, erdulden
sahara - n. Hilfe, Beistand, UnterstuÃàtzung
sahasrabdi - n. Jahrtausend, Millennium
san. Hilfe, Beistand, UnterstuÃàtzung
sahayak - n. Helfer, Assistent 
sahayak nadi - n. Nebenflu√ü
sahayata - n. Hilfe, Beistand, UnterstuÃàtzung
sahayog - n. Zusammenarbeit, Kooperation
sahayog samiti - n. Kooperationsgesellschaft
sahayogi - n. Helfer, Assistent, Mitarbeiter, Kollege, Freund
sahinlo  - n. DrittaÃàltester [von BruÃàdern] n. Literatur, Schrifttum
sahityakar - n. Schriftsteller
sahityashastra - n. Literatur, Dichtung, rhetoric 
sahityik - adj. literarisch
sahu - n. Geldverleiher, HaÃàndler, Kaufmann
sahu - n. Kaufmann, HaÃàndler, Ladenbesitzer
sahunu - n. Ladenbesitzerin, Kauffrau
saiddhantik - adj. aus Prinzip, gemaÃà√ü dem Prinzip, im Prinzip, prinzipiell, theoretisch 
sainik -  adj. militaÃàrisch
sainik viman - n. MilitaÃàrflugzeug
saintis - num. siebenunddrei√üig, 37 
saja - n. Bestrafung, Strafe
sajaya - n. Bestrafung, Strafe
sajha - n. Kooperative, Genossenschaft 
sajilo - adj. leicht, einfach
sakali - adj. wirklich, real, unverfaÃàlscht, original, wahr
sakbhar - adv. so viel wie moÃàglich
sakesamma cando - comp. so schnell wie moÃàglich, so bald wie moÃàglich
saknu - v.t. koÃànnen, imstande sein, beenden
saksham - adj. faÃàhig, geeignet, kompetent, wirkungsvoll
sakshar - adj. des Schreibens und Lesens kundig, gebildet
saksharta - n. FaÃàhigkeit des Lesens und Schreibens
sal - n. Jahr [des vikram samvat]
salabalaunu - v.i. sich ruhelos bewegen [wie ein Wurm]
salah - n. Heuschrecke
salai - n. StreichhoÃàlzer
salaiko bata - n. Streichholzschachtel adj. durchschnittlich, im Durchschnitt 
salana - adj. jaÃàhrlich
sali - n. juÃàngere Schwester der Ehefrau
salig - n. Statue, Bildnis
salik - n. Statue, Bildnis
salinda - adj. jaÃàhrlich
sallaha - n. Rat, Ratschlag, Beratung, Konferenz Berater
salo - n. juÃàngerer Bruder der Ehefrau
samacar - n. Nachricht, Information
samadhan - n. Nachricht, Information 
samadhan - n. ProblemloÃàsung
samagra - adj. ganz, vollstaÃàndig, voÃàllig 
samaj - n. Gesellschaft, Gemeinschaft, Partei
samaj shastra - n. Soziologie, Sozialdienst
samajik - adj. sozial, gesellschaftlich 
samajvad - n. Sozialismus
samajvadi - n./adj. Sozialist, sozialistisch 
samajvadi rajya - n. sozialistischer Staat 
samaksha - postp. vor [oÃàrtl.]
samalocana - n. Kritik, Besprechung
saman - n. Material, Apparat, Werkzeug, Dinge
saman - adj. gleich, aÃàhnlich, gleichwertig, uÃàbereinstimmend, identisch
samanata - n. Gleichheit, Gleichwertigkeit, AÃàquivalenz
samanti - adj. feudal
samanvaya - n. Kombination, Koordination, Verbindung, Union, Harmonie, natuÃàrliche Nachfolge
samanya - adj. gemein, allgemein, gewoÃàhnlich, uÃàblich, einfach
samanaya ling - n. doppeltes Geschlecht [grammatisch]
samanya nam - n. Gattungsbegriff
samapta - adj. abgeschlossen, beendet, fertig, vollendet
samarpan - n. Opferung,Unterwerfung adj. maÃàchtig, stark, faÃàhig 
samarthak - n./adj. AnhaÃànger, UnterstuÃàtzer, FoÃàrderer, Helfer; unterstuÃàtzend
samarthan - n. UnterstuÃàtzung, BestaÃàtigung, Ratifizierung
samarthata - n. FaÃàhigkeit,Kompetenz adj. ganz, vollstaÃàndig
samasti - n. Geschlossenheit, Gesamtheit
samastigat -  adv. geschlossen, gesamt, vereint
samasya - n. Problem, Dilemma
samsyagrasta - adj. problematisch, problemreich
samata - n. Gleichheit
samatal - adj. flach, eben
samay - n. Zeit, Periode, Gelegenheit 
sambal - n. UnterstuÃàtzung
sambandkha - n. Beziehung, VerhaÃàltnis
sambandi - suff. bezogen auf, in Verbindung mit
sambandi sarvanam - n. Relativpronomen
sambhavana - n. MoÃàglichkeit, Wahrscheinlichkeit
sambhavataha - adv. ploÃàtzlich, vermutlich, moÃàglicherweise, wahrscheinlich
sambranta - adj. perplext, verwirrt, verbluÃàfft, verdutzt, bestuÃàrzt
sambodhan - n. Ansprache, Rede; Vokativ 
samcar - n. Nachricht, Information
samdhi - n. Schwiegervater des Sohnes oder der Tochter
samdhini - n. Schwiegermutter des Sohnes oder der Tochter
samet - postp. mit, zusammen mit, einschlie√ülich, auch
saminya - adj. gemein, einfach
samiti - n. Komitee
samjhana - n. GedaÃàchtnis, Erinnerung 
samma - postp. bis, bis zu [zeitl., oÃàrtl.] 
sammat - adv. zugestimmt, der gleichen Meinung
sammati  - n. Zustimmung, UÃàbereinstimmung, Meinung
sammelan - n. Treffen, Versammlung, Konferenz
sammilit - adj. mit geschlossenen Augen, bedeckt
sammyaunu - v.t. ebnen
sampadak - n. Herausgeber
sampadakiya - adj. redaktionell, Redaktions- 
sampadakiya sahayak  - n. Redaktionsassistent
sampadakiya vibhag - n. Redaktion, Redaktionsabteilung
sampana - adj. florierend, bluÃàhend, gutgehend, wohlhabend, reich
samparka - n. Verbindung, Vereinigung, Union, Verband, Gesellschaft
sampradaya - n. Religionsgemeinschaft, Sekte
sampurna - adj. alle, ganz, vollstaÃàndig
samrat - n. Herrscher, SouveraÃàn, OberkoÃànig
samriddha- adj. wichtig, bedeutend 
samu - postp. vor, gegenuÃàber
samuccaya - n. Sammlung, Kollektion 
samudaya - n. Versammlung, Gruppe, Gemeinschaft 
samudayavacak nam - n. Sammelbegriff
samudayik - adj. gemeinsam, gemeinschaftlich
samudra - n. Ozean, Meer, die See
samudra sataha - n. MeereshoÃàhe
samudaya - n. Versammlung, Gruppe 
samuhik - adj. kollektiv, gemeinschaftlich 
samunnati - n. Fortschritt,Entwicklung, Entstehung
samyatantra - n. Kommunismus
samyavad - n. Kommunismus
samyavadi - n./adj. Kommunist, kommunistisch 
san - n. Jute
sana buva - n. Ehemann der juÃàngeren Schwester der Mutter 
sancalan - n. DurchfuÃàhrung
sancalan - n. Bewegung
sancalit - adj. geleitet, gefuÃàhrt 
sancar - n. Bewegung
sancaran - n. Bewegung
sanco - n./adj. SchluÃàssel; wahr, wirklich, tatsaÃàchlich
sandarbha - n. Bildung, Formation, Konstruktion, Komposition
sandarbha-suci - n. Literaturverzeichnis
sandesh - n. Information, Nachricht, Botschaft, Mitteilung
sandhe - n. Bulle,Stier
sangai lanu - postp. mit, bei, im unmittelbaren Besitz von
sangai lanu - v.t. mitnehmen
sangasangai - adj. zusammen
sanngathan - n. Organisation, Vereinigung 
sanggathannatmak- adj. organisatorisch
sanggathankik - adj. organisatorisch
sanggharsa - n. Konflikt, Streit, Kampf
sangh - n. Vereinigung, Verbindung, Verband, Union 
sanghu - n. BruÃàcke
sangkalan - n. Sammlung, Versammlung
sangkalapa - n. feierliches GeloÃàbnis, LoÃàsung, Entschlossenheit
sangkat - n. Not,Elend,Katastrophe, Mangel
sangkat - n. Symbol, Geste, Zeichen 
sangkeitk - adj. nominell, symbolisch
sanglo - n. klar[FluÃàssigkeiten]
sanguro - adj. eng, schmal
sangyojik - n. Konjunktion
sangyukta rastra sangah - UNO 
sani ama - n. juÃàngere Schwester der Mutter
saniscavar - n. Samstag, Sonnabend 
saniscavar - n. Samstag, Sonnabend 
sanjha - adv. am Abend
sanjha paryo  - es wurde Abend
sankhyabodhak - adj. numerisch, Zahl- [grammatisch]
sankhyamatrabodhak - n. Kardinalzahl
sankramankal - n. UÃàbergangsperiode, UÃàbergangszeit, UÃàbergangsohase 
sano - adj. klein, gering
sanp - n. Schlange
sanracana - n. Struktur, Zusammensetzung, Komposition, Anatomie
sanrakshak - n. WaÃàchter, BeschuÃàtzer, BehuÃàter, Bewahrer, Erhalter
sanrakshan - n. Schutz, Erhalt, FoÃàrderung, Konservierung
sansad - n. Parlament
sansadiya - adj. parlamentarisch 
sansadiya vyavastha - n. parlamentarische Angelegenheiten
sanshodhan - n. Berichtigung,Korrektur, AÃànderungVerbesserung, Erneuerung, Reform
sanshodhit - adj. verbessert,gereinigt, bereinigt
sanskar - n. Reformation, Initiation, Reinigung
sanskaran - n. Edition, Ausgabe n. Sanskrit
sanskriti - n. Kultur
sanskritik - adj. kulturell
sanskritimaya - adj. voll von Sanskrit, sanskritisiert
sansmaran - n. Erinnerung
sanstha - n. Einrichtung, Institution 
sansthagat - adj. institutionell
sansthan - n. (literarische) Vereinigung, Institution
sansthapan - n. Einrichtung, Schaffung, GruÃàndung
santa - n. Heiliger
santa-mahanta - n. heilige MaÃànner
santan - n. (erweiterte) Familie, Lineage, Genealogie, Nachkommenschaft, Kinder
santanabbe - num. siebenundneunzig, 97
santan-nigraha-  n. Geburtenkontrolle, Familienplanung
santan-nirodh - n. Geburtenkontrolle, Familienplanung
santaunna - num. siebenundfuÃànfzig, 57
santulan - n. Gleichsetzung, Gleichstellung
sanu - adj. klein
sanvaidhanik - adj. verfassungsmaÃà√üig,die Verfassung betreffend, konstitutionell
sanvarddhan - n. Schutz, Pflege
sanvedanshil - adj. sensibel,einfuÃàhlsam, sensitiv
sanvidhan - n. Verfassung
saph - adj. sauber, rein
saphal - adj. erfolgreich, fruchtbar, effektiv
saphalibhut - adj. erfolgreich, fruchtbar, effektiv
saphalta - n. Erfolg
sar - n. Zusammenfassung, UÃàbersicht, Substanz, Essenz
sara - adj. alle, alles, ganz, gesamt
saraha - adj. aÃàhnlich, so
saral - adj. leicht, einfach
saranggi - n. Sarangi [eine Art Fiedel] 
sarapnu - v.t. fluchen, verfluchen
saripha - n. Zimtapfel
sarkar - n. Regierung, Verwaltung
sarkari - adj. oÃàffentlich, administrativ, amtlich, die Regierung betreffend, Amts-, Regierungs-
sarkari bhasa - n. Amtssprache, Verwaltungssprache
sarnu - v.t. bewegen, entfernen, wegnehmen, verlegen
sarnu - v.i. sich bewegen, sich ausbreiten, sich breit machen
sarp - n. Schlange
sarva - adj. ganz, vollstaÃàndig
sarvahara - n. Proletariat
sarvajan - pron. jeder, jedermann, alle
sarvajanik - adj. oÃàffentlich
sarvanam - n. Pronomen
sarvanamik - adj. pronominal
sarvapracin - adj. aÃàltester
sarvashrestha - adj. bester
sarvasva - n. Gesamtbesitz, das gesamte Eigentum einer Person
sarvatomukhi - adj. universal, allgemein guÃàltig, alles durchdringend
sarvekshan - n. Erforschung,Untersuchung
sarvesarva - adj. allmaÃàchtig, mit aller Macht ausgestattet
sasana - n. Bestrafung, UnterdruÃàckung, Tyrannei
sashakta - adj. maÃàchtig
sashastra - adj. bewaffnet
sasto - adj. billig
sasu - n. Schwiegermutter
sasura - n. Schwiegervater
sasuro - n. Schwiegervater
sat - n. Essenz, Auszug, Wahrheit 
sat - num. sieben, 7
sata - n. Woche, Zeitraum von sieben Tagen
sataha - n. OberflaÃàche
satahi - n. Austausch, Wechsel 
satani - n. Tausch, Austausch, Wechsel
satasi - num. siebenundachtzig, 87
staun - adj. siebte, siebter
satcalis - num. siebenundvierzig, 47 
sath - postp. mit, einschlie√ülich
sathattar  - num. siebenundsiebzig, 77
sathi - n. Freund
sathi - num. sechzig, 60
sati - n. Sati, tugendhafte Ehefrau, keusche Frau
satoputlo - n. Bewu√ütsein, Geistesgegenwart
satra - num. siebzehn, 17
satsatthi - num. siebenundsechzig, 67
satta - n. Austausch, Wechsel
satta - n. Spekulation, Vermutung 
sattais - num. siebenundzwanzig, 27 
sattari - num. siebzig, 70
sattarudh - adj. herrschend, machthabend 
satu - n. Mehl aus trochengebratenem Mais 
satya - adj. wahr, wirklich, korrekt
saun - n. vierter Monat des nepalischen Kalenders [Juli-August] SchoÃànheit
saunvar - n. Montag
saurya - adj. solar
sauta - n. Nebenfrau
sava - adj. Viertel nach [bei Uhrzeiten] 
saval - n. Frage, Lot, Senkblei
saya - num. hundert, 100
sekaunu - v.t. roÃàsten,aufwaÃàrmen
sekuwa - n. geroÃàstetes Fleisch
selaunu - v.t. kuÃàhlen
selroti - n. nepalische Krapfen aus Reismehl 
sepilo - adj. schattig
seto - adj. wei√ü
seva - n. Dienst
sevan - n. Dienst
shabda - n. Wort
shabdakos - n. WoÃàrterbuch
shahar  - n. Stadt
shaharikaran - n. VerstaÃàdterung, Urbanisierung
shahi - adj. koÃàniglich
shahid - n. MaÃàrtyrer
shakta - adj. maÃàchtig, stark
shakti - n. Kraft, StaÃàrke, Macht 
shaktihina - adj. machtlos, unfaÃàhig
shaktiman - adj. maÃàchtig, stark
shaktiparikshan - n. KraÃàftemessen
shaktishali - adj. maÃàchtig, stark
shamel - adj. versammelt, vereinigt, verbuÃàndet
shamil - adj. versammelt, vereinigt, verbuÃàndet
shangka - n. Zweifel, Verdacht, Vorbehalt
shankalu - adj. verdaÃàchtig, fraglich, vage
shankardeva - n. Shankaradeva [ein Licchavi-KoÃànig, Gro√üvater von Manadeva I.] 
shanta - adj. ruhig, still
sharad - n. FruÃàhherbst 
sharan - n. Schutz
sharanarthi - n. FluÃàchtling 
sharat - n. FruÃàhherbst 
sharir - n. KoÃàrper
shasak - n. Verwalter, Gouverneur, Herrscher
shasakiya - adj. Regierungs-, Verwaltungs-, administrativ, oÃàffentlich
shasakiya - n. Regierung, AutoritaÃàt, Herrschaft, Herrschergewalt, Befehl, Verwaltung
shasan - n. Regierungsumsturz, Putsch
shasana - n. Bestrafung, UnterdruÃàckung, Tyrannei
shasankal - n. Regierungszeit
shasankarta - n. Verwalter, Gouverneur
shasanpaddhati - n. Regierung, Verfassung 
shasanapranali - n. Regierung, Verfassung 
shasantantra - n. Regierung, Verfassung 
shasit - adj. verwaltet, regiert
shastra - n. Waffen, GeraÃàt, Instrument, Werkzeug
shatabd - n. Jahrhundert
shatabdi - n. Jahrhundert
shatak - adj. 100, einhundert
shatru  - n. Feind
shatruta - n. Feindschaft
shaucalaya - n. Toilette
shav - n. Leichnam
shayad - adv. vielleicht
sherpa - n. Sherpa [eine VolksgruppeNepals]
shikariko svarg - n. Jagdparadies
shiksha - n. Erziehung, Bildung, Ausbildung
shikshak - n. Lehrer
shikshan - n. Lehre, Schulung
shir- n. Kopf, Spitze
Shista - adj. gehoben, hoÃàflich, gewaÃàhlt 
Shisya - n. Student, SchuÃàler
shithilta - n. Lockerheit, Gelassenheit 
shlok - n. Vers, Strophe
shobha - n. SchoÃànheit, Glanz
shos - n. Absorbtion, das Aufsaugen, Sog, Aussaugen, Austrocknen
shosak - adj. absorbierend, vernichtend
shosan - n. Absorbtion, das Aufsaugen, Sog, Aussaugen, Austrocknen, Ausbeutung 
shosit - adj. ausgebeutet
shram - n. Einsatz, Anstrengung, Angagement, MuÃàhe, harte Arbeit
shravan - n. vierter Monat des nepalischen Kalenders [Juli-August]
shri - n. Herr, Frau, FraÃàulein [Anrede]
shrilangka - n. Sri Lanka
shriman - n. Ehemann [hoÃàflich], Gatte 
shirmati - n. Ehefrau [hoÃàflich], Gattin 
shuddha - adj. richtig, korrekt
shukavar - n. Freitag
shukla paksha - comp. helle MonatshaÃàlfte [des astrologischen Kalenders] 
shukravar - n. Freitag
shunya - n./adj. leer, Null, 0
shur - adj. tapfer, mutig, verwegen, kuÃàhn, maÃàchtig
shuru - n. Anfang, Beginn anfangen, beginnen
shyarpa - n. Sherpa
siddhanta - n. Lehre, Doktrin 
siddhi - n. Perfektion, Vollkommenheit, Fertigkeit, Reife, ErfuÃàllung, Sieg
siddhyaunu - v.t. beenden, abschlie√üen 
siknu - v.t. lernen
silbar - n. Aluminium
siling - n. Decke (eines Raumes) 
sima - n. Grenze
simana - n. Grenze
sinbi - n. Bohne
simit - adj. begrenzt, beschraÃànkt 
simi - n. Bohne
sincai - n. BewaÃàsserung
sincit - adj. bewaÃàssert
sindur - n. Mennige-Puder, GluÃàckszeichen
sindure - adj. scharlachrot
sinha - n. LoÃàwe
sinhasan - n. Thron, KoÃànigsthron
sinki - n. gesaÃàuerter Rettich
sip - n. Handwerk, Handarbeit, Geschicklichkeit 
sipahi - n. Soldat
sipalu - adj. geschickt, erfahren, kundig, klug
sipharish - n. Empfehlung n. Steppdecke n. Kissen
sirjana - n. SchoÃàpfung 
sisa - n. Blei
sita - postp. mit, bei, im unmittelbaren Besitz von
siune kal - n. NaÃàhmaschine
siunu - v.i. naÃàhen, sticken
siyo - n. Nadel
skulma padhnu - comp. zur Schule gehen, die Schule besuchen
smaran-patra - n. Memorandum, Mahnung
smarika - n. Andenken, Souvenir
smriti - n. Erinnerung
smrita patra - n. Memorandum, Mahnung 
snan - n. Bad
snankotha - n. Badezimmer
so - adj. jene. jener
sobhita - n. Kobalt
socnu - v.t. uÃàberdenken
sodhakhoj - n. Forschungsziel, ForschungsbemuÃàhen, UntersuchungsbemuÃàhen, Anliegen der Untersuchung
sohra - num. sechzehn, 16
sojho - adj. gerade, geradeaus
somvar - n. Montag
sopan - n. Stufen, Leiter, Treppe 
spast - adj. bestimmt, klar, offensichtlich, deutlich
sresta - n. offizielle Korrespondenz
srot - n. Quelle, Wasserlauf, Bach, Kanal, Flu√ü, Strom, Einkommensquelle 
srot ra sadhan - n. Ressourcen
stambha - n. Kolumne
stan - n. Brust
stava - n. Anbetungshymne, Gebet, Anrufung 
steshan - n. Bahnhof
sthagit - adj. verschoben
sthan - n. Platz, Stelle, Ort
sthaniya - adj. lokal, regional, oÃàrtlich, territorial
sthapan - n. Errichtung, Bau, Konstruktion, GruÃàndung, Schaffung, SchoÃàpfung
sthapana - n. Errichtung, Bau, Konstruktion, GruÃàndung, Schaffung, SchoÃàpfung
sthapit - adj. eingerichtet, errichtet, aufgebaut, begruÃàndet, institutionalisiert, installiert
sthayi - adj. bestaÃàndig, dauerhaft, stabil, permanent
sthayitva - n. Dauerhaftigkeit, Nachhaltigkeit
sthira - adj. unbeweglich, fest, standhaft
sthirata - n. Standhaftigkeit, Unbeweglichkeit, Stagnation
sthirata - n. Standhaftigkeit, Unbeweglichkeit, Stagnation
sthiti - n. Platz, Stellung, Beschaffenheit, Zustand, Umstand, Gegebenheit
striling - n. Femininum [grammatisch]
stuti - n. Anbetungshymne, Gebet, Anrufung
subista - n. Annehmlichkeit, Komfort, Bequemlichkeit
subistako - adj. angenehm, komfortabel
sucana - n. Anmerkung, Notiz, Information, Anzeige
sucanapatra - n. Anzeige, Notiz
suci - n. Nadel, spitzer Gegenstand aus Eisen; Stachel
suci - n. Inhaltsverzeichnis, Liste, Tabelle, Tarif
sudhar - n. Reform, Berichtigung, Verbesserung, Korrektur, Erneuerung
sudharak - n. Reformer, Reformator
sudharnu - v.t. verbessern, korrigieren, veraÃàndern, reformieren
sudridha - adv. sehr stark, sehr streng n. Papagei
sujhau - n. Vorschlag,Rat
sujhav - n. Vorschlag,Rat
sukhi - adj. angenehm, erfreulich, gluÃàcklich
sukhiya - adj. angenehm, erfreulich
sukti - n. guter Ausdruck, schoÃàner Satz
sukul - n. eine Art Strohmatte, eine Person aus einer hochgeachteten Familie
sukumvasi - n./adj. Mittelloser, Besitzloser, Landloser, heimatlos, obdachlos
sukuti - n. getrocknetes Fleisch, Trockenfleisch
sun - n. Gold
sunaulo - adj. golden
sunaunu - v.t. hoÃàren lassen, erzaÃàhlen
sundar - adj. schoÃàn, huÃàbsch, nett
sundha - n. RuÃàssel
sungur - n. Schwein, Hausschwein
suntala - n. Mandarine
suntale - adj. orange
sunuvar - n. Sunuwar [eine VolksgruppeNepals] 
supari - n. Betelnu√ü
suraksha  - n. Sicherheit,Schutz, Verteidigung
surakshit - adj. wohlbehuÃàtet,sicher
surti - n. Tabak
suruva - n. Fleischsuppe,FleischbruÃàhe 
surya - n. Sonne
susajjit - adj. wohlgeschmuÃàckt, herausgeputzt 
susangat - geeignet, logisch, vernuÃànftig
susangata - n. GuÃàltigkeit, Relevanz, Vernunft
susangati - n. GuÃàltigkeit, Relevanz, Vernunft
suselnu - v.t. pfeifen
suselo - n. das Pfeifen
sushasan - n. gute Regierung, gute Verwaltung
sushri - n. FraÃàulein [Anrede]
susta - adj. faul, traÃàge, langsam, inaktiv 
sutne kotha - n. Schlafzimmer
sutnu - v.i. schlafen, schlafengehen, zu Bett gehen
sutrapat - n. Anfang,Beginn
suvidha - n. Einrichtung, Annehmlichkeit, Komfort, Bequemlichkeit
suvista - n. Annehmlichkeit, Komfort, Bequemlichkeit
svabhav - n. Verhalten, Natur, natuÃàrliche Beschaffenheit
svabhavatah - adv. natuÃàrlich, von Natur aus 
svabhavik - adj. natuÃàrlich, angeboren 
svachha - adj. klar, sauber, rein, transparent 
svad - n. Geschmack
svadhin - adj. unabhaÃàngig, frei
svadhinata - n. UnabhaÃàngigkeit, Freiheit
svami - n. Herr, Besitzer, EigentuÃàmer, Ehemann, Gatte
svar - n. Stimme, Klang, Laut. Vokal
svarg - n. Himmel, Paradies
svargavas - n. Dahinscheiden, Tod
svarup - n. Form, Erscheinungsbild n. Ehefrau, Gattin
svasni - n. Frau
svasth - adj. gesund
svasthya - n. Gesundheit
svatah - adj. freiwillig, spontan, von selbst
svatantra - adj. unabhaÃàngig, frei
svatantrata - n. UnabhaÃàngigkeit, Freiheit 
svatantrata divas - n. UnabhaÃàngigkeitstag 
svayam - adv. selbst, persoÃànlich
svayambhunath - n. Svayambhunath
svayamev - adv. pers√∂nalich, selbst 
svayamsevak -  n. Freiwilliger, Scout 
svayatta - adj. autonom
svayatta shasan - n. Autonomie, autonome Regierung
svayattashasi - adj. autonom
svayattata - n. Autonomie
svikar - n. UÃàbereinstimmung, Annahme, Zustimmung, Akzeptierung, UÃàbereinkunft
svikrit - adj. angenommen, anerkannt, akzeptiert
svikrtit - n. Annahme, Zustimmung, Akzeptierung, UÃàbereinkunft
syal - n. Schakal
syau - n. Apfel
tadha - adj. weit, entfernt
tadkanu - v.i. eilen, schnell gehen, schreien
tadkinu - v.i. eilen, schnell gehen, schreien
tai - n. flache Eisenpfanne 
taipani - conj. dennoch
taja - adj. frisch
tak - n. Zeit, Stunde, Chance, Gelegenheit
tak - n. Reflektion, Betrachtung
takaliph -n. Problem, Kummer, Sorge 
takiya - n. Kissen
takuro - n. Gipfel
tal - n. Teich, der See
tala - n. Riegel, Schlo√ü
tala - postp. unten, unter
tala - n. Stockwerk
talak - postp. bis zu
talcha - n. Riegel, Schlo√ü
talika - n. Liste, Tabelle, SchluÃàssel
talim - n. UÃàbung, Unterricht, Training 
talkanu - v.i. scheinen, glitzern, funkeln, schimmern
talkinu - v.i. scheinen, glitzern, funkeln, schimmern
talmel - n. Koordination, Harmonie n. Gaumen
tama - n. Kupfer, Bambusspitze n. Tabak
tamakhu - n. Tamang [eine Volksgruppe Nepals]
tamsanu - v.i. aktiv sein, fortschrittlich sein
tamu - n. Tamu, Gurung [eine Volksgruppe Nepals]
tanahun - n. Tanahun [einstiger Kleinstaat, heute Distrikt Nepals]
tanav - n. Spannung
tanba - n. Kupfer
tanna - n. Bettlaken
tannu - v.t. ziehen, einziehen, inhalieren
tansnu - v.t. befestigen, festmachen, anheften, feststecken
tap - n. Bu√üe, UÃàbung, Hitze, WaÃàrme
tap - n. Hitze, WaÃàrme, Fiebertemperatur
tapani - conj. obgleich, obschon, nichtsdestoweniger
tapari - n. ein Teller aus BlaÃàttern 
tapke - n. Bratpfanne
tar - n. Sahne
tara - n. Stern
tara - conj. aber
taranga - n. Welle, Neigung, Haltung, Geisteshaltung
taraph - n. Richtung, Seite
taraph - conj. nach, in Richtung auf
tarbuja - n. Wassermelone
tari khet - n. Feldterrasse
tarika - n. Methode, Art und Weise 
tarikh - n. Datum [nach dem westlichen Kalender]
tark - n. Debatte, Diskussion, Argument
tarkari - n. GemuÃàsecurry
tarnu - v.t. stark braten
tarph - conj. nach, in Richtung auf n. Richtung, Seite
tarphbata - postp. von Seiten, seitens
tarul - n. Yam
tarun - n. junger Mann, JuÃàngling 
taruno - n. junger Mann, JuÃàngling 
tasartha - int. von daher, aus diesem Grund
taskar - n. Schmuggler
taskari - n. Schmuggel
tat - n. Ufer, KuÃàste
tatastha - adj. neutral, objektiv
tataunu - v.t. erwaÃàrmen, erhitzen, aufwaÃàrmen 
tatha - conj. und
tathya - n. Wahrheit, RealitaÃàt, Substanz
tato - n. Schatten, Fleck
tato - adj. hei√ü, warm
tato pani - n. hei√ües Wasser, warmes Wasser
tattva - n. Wahrheit, letztliche Ursache
tau - n. Papierblatt
tauko - n. Kopf
taulanu - v.t. waÃàgen,pruÃàfen,abschaÃàtzen, auf die Waagschale legen 
tauliya - n. Handtuch
tavar - n. Methode, Art, Weise
tayar - adv. fertig
tayar garnu - v.t. fertig machen
tayar hunu - v.i. fertig sein, bereit sein
tayarima - n. Bereitschaft, Vorbereitung 
tebbar - adj. dreifach [bei GegenstaÃànden] 
tehra - num. dreizehn, 13
teis - num. dreiundzwanzig, 23 
tekne lauro - n. Wanderstab
telbij - n. OÃàlsamen
telha - n. OÃàlsamen
tenis - n. Tennis
ternu - v.t. beachten, Aufmerksamkeit schenken
tesro - adj. dritte, dritter
tesro dhrava - n. dritter Pol
tettis - num. dreiunddrei√üig, 33
thag - n. BetruÃàger, Schwindler, Schurke
thagaha - n. BetruÃàger, Schwindler, Schurke
thagnu - v.i. taÃàuschen, betruÃàgen
thaha - n. Wissen, Kenntnis
thakai - n. ErschoÃàpfung, ErmuÃàdung, Abspannung
thakali - n. Thakali [eine Volksgruppe Nepals]
thaknu - v.i. erschoÃàpft sein, muÃàde sein, muÃàde werden
thai - n. Teller
thali - n. kleiner Teller
thalni - n. Anfang, Beginn
thalnu - v.t. anfangen, beginnen 
thalo - n. Platz, Stelle, Land; Hochebene, Tafelland 
thamaunu - v.t. erkennen, wissen
thami - n. Thami [eine Volksgruppe Nepals]
thamyaunu - v.t. erkennen, kennen 
thana - n. Polizeistation
thanda - adj. kuÃàhl, kalt
thanda marubhumi - n. KaÃàltewuÃàste, Tundra
thannu - v.t. uÃàberdenken, entscheiden v.t. errichten, aufrichten, platzieren
thar - n. Stamm, Klan, Unterkaste
tharkaunu - v.t. erschuÃàttern, erschrecken
tharu - n. Tharu [eine Volksgruppe Nepals]
thati - n. Pfand, Sicherheit, Verschiebung
thaun - n. Platz, Stelle, Ort, Gelegenheit
thegnu - v.i. dauern, bestehen, uÃàberdauern, aushalten
theknu - v.t. vormerken
thicnu - v.t. druÃàcken, pressen, quetschen
thik - adj. richtig, korrekt
thiti - n. MaÃàdchen
thiti - n. Brauch, Brauchtum, Sitte 
thiti-riti - n. Brauch, Brauchtum, Sitte 
thito - n. Junge, junger Mann
thople - adj. gepunktet, gefleckt
thopo -  n. Tropfen
thor - adj. einige, wenige, ein wenig, etwas
thorai - adj. ein wenig, etwas, einige, wenige
thuli ama - n. Frau des aÃàlteren Bruders des Vaters, aÃàltere Schwester der Mutter 
thulo - adj. gro√ü
thulo ba - aÃàlterer Bruder des Vaters, Ehemann der aÃàlteren Schwester der Mutter
thulo buva - aÃàlterer Bruder des Vaters, Ehemann der aÃàlteren Schwester der Mutter
thunse - n.
thunuva - adj. verhaftet
thuprai aunu - v.i. hereinstr√∂men, herinschw√§rmen
thupro - n- Haufen, Menge
ti - pron. jene
tibbat - n. Tibet
tighra - n. Schenkel
tihun - n. GemuÃàseeintopf
tikho - adj. spitz, bei√üend 
tiknu - v.i. dauern, andauern, verbeliben, uÃàbrigbleiben 
til - n. Sesam
tin - n. Zinn
tin - num. drei, 3
tinma - unter ihnen, darunter etwas mehr als die HaÃàlfte von ihnen
tippani - n. Kommentar, Anmerkung
tippanikar - n. Kommentator
tira - postp. in Richtung auf, nach,  uÃàber 
tirnu - v.t. bezahlen
tirsana - n. Wunsch, Verlangen 
tis - num. drei√üig, 30
tithi - n. Datum [nach dem astrologischen Kalender]
titri - n- 
toknu - v.t. festsetzen, festlegen, bestimmen
toli - n. kleine Gruppe, Mannscharft, Team
topalnu - v.t. so tun als ob, vorgeben 
tori - n. Senf
toriko phul dekhnu - uÃàberrascht sein, erstaunt sein
tran - n. Schutz, Verteidigung, Sicherheit
tribhuj - n. Dreieck
tricalis - num. dreiundvierzig, 43
trihattar - num. dreiundsiebzig, 73
tripanna - num. dreiundfuÃànfzig, 53
trisatti - num. dreiundsechzig, 63
tritiya purus - n. dritte Person [grammatisch] 
tritiyapurusvacak - n. 3. Person [grammatisch]
triyanabbe - num. dreiundneunzig, 93
triyasi - num. dreiundachtzig, 83
tukra - n. [kleines] StuÃàck, Portion
tukrinu - v.i. aufgeteilt werden
tulana - n. Vergleich
tunginu - v.i. zu Ende gehen, fertig sein 
tupi - n. Zopf
turunta - adj. sofort
tyag - n. Desertierung, Fahnenflucht 
tyahan - adv. dort, dorthin
tyas tak - adv. zu jener Zeit
tyasai - adv. nur so, ohne Grund
tyasaile - conj. daher
tyaso hunale - conj. daher, also, deshalb, aus diesem Grund 
tyasprati - adv. diesbezuÃàglich
tyasto - pron. solcher Art, solcher
tyatiko - adj. so viel, so gro√ü
ubhayaling - n. doppeltes Geschlecht [grammatisch]
ubhinu - v.i. stehen, aufstehen, sich aufrichten
ubhyaunu - v.t. aufrichten, zum Stehen bringen, erheben
ubjani - n. Produktion, ProduktivitaÃàt
ubjanu - v.i. wachsen, heranwachsen, hergestellt werden, angebaut werden
ubjaunu - v.t. herstellen, produzieren, wachsen lassen, anbauen
ubranu - v.i. uÃàbrigbleiben
ucalnu - v.t. heben, erheben
ucca - adj. hoch, gro√ü
ucca parvatiya - adj. alpin
udaharan - n. Beispiel, ErlaÃàuterung adj. beispielhaft
udan - n. Flucht
udar - adj. ehrenwert, honorig, freigebig, gro√ümuÃàtig, vorurteilsfrei, liberal
udarashaya - adj. ehrenwert, honorig, freigebig, gro√ümuÃàtig, vorurteilsfrei, liberal
udarta - n. Freigebigkeit, Edelmut, LiberalitaÃàt
udarvad - n. Liberalismus
udarvadi - n. Liberaler, Liberalist
udas -  adj. traurig
udasi - adj. traurig
udaunu - v.t. hochheben, wegjagen, wegfegen, wegrei√üen, hochjagen, aufscheuchen, fliegen, schwirren, verschwenden, vergeuden, verschlingen
udaunu - v.i. aufgehen (Sonne oder Mond)
udaya - n. Aufstieg, Fortschritt, DaÃàmmerung
uddesh - n. Wunsch, Verlangen
uddeshya - n. Ziel, Zweck
uddhar - n. Freundlichkeit, GuÃàte n. Ausruf, emotionale AÃàu√üerung 
udharnu - v.t. aufrei√üen
udhinnu - v.t. ausgraben,herausfinden, suchen
udnu - v.i. fliegen
udus - n. Bettwanze
udamashil - adj. flei√üig
udyat - adj. bereit, fertig, aufgezogen 
udyog - n. Industrie
udyogi - adj. industriell
ugharnu - v.t. oÃàffnen, entriegeln
ughranu - v.i. offen sein, eroÃàffnet sein, geoÃàffnet sein
ugra - adj. zornig, grimmig, wutentbrannt, wuÃàtend
uhan - pron. er, sie [sehr hoÃàflich]
uhile - adv. dann, damals, zu jener Zeit, vor langer Zeit
ujad - adj. verwuÃàstet, ruiniert, desolat adj. hell, klar
ukali - n. Steigung
ukalnu - v.t. aufheben
ukalo - n./adj. Steilheit, Steigung; steil
ukasnu - v.t. aufheben, erheben, freisetzen, befreien
uskelnu - v.t. erbrechen, ausspucken
ukhan - n. Sprichwort, Redewendung, Aphorismus
ukhelnu - v.t. entwurzeln, entfernen 
ukhu - n. Zuckerrohr
ukkaunu - v.t. aufbrechen, eroÃàffnen, initieren, veranlassen
ukkinu - v.i. auserlesen sein, auserwaÃàhlt sein
ukalnu - v.t. hinaufklettern, hinaufsteigen, besteigen
ukta - adj. genannt, erwaÃàhnt
ukti - n. Anmerkung, Kommentar, Redensart
ukusmukusaunu - v.t. ersticken,erwuÃàrgen, Platzangst verursachen
ullangghan - n. Verletzung, Mi√üachtung
ullas - n. Freude, VergnuÃàgen
ullekh - n. ErwaÃàhnung, Beschreibung, Nennung
ullekhniya - adj. erwaÃàhnenswert, genannt, erwaÃàhnt, beschrieben
ullikhit - adj. genannt, erwaÃàhnt, beschrieben
ulto - adj. gegenteilig, umgekehrt
umalnu - v.t. kochen [FluÃàssigkeit], zum Kochen bringen
umarnu - v.t. wachsen lassen, anbauen, anpflanzen, sprie√üen lassen 
umedvar - n. Kandidat
umer - n. Alter, Lebensalter
umkanu - v.i. entkommen, entrinnen, freikommen
umalnu - v.i. kochen, sieden, aufwallen 
ummedvar - n. Kandidat
umranu - v.i. angebautwerden, angepflanzt werden, sprie√üen
un - n. Wolle
unannabe - num. neunundachtzig, 89 
unansattari - num. neunundsechzig, 69 
unansaya - num. neunundneunzig, 99 
unasi - num. neunundsiebzig, 79
unca - adj. hoch, hochragend
ucai - n. HoÃàhe, GroÃà√üe, Gipfel 
ucalis - num. neununddrei√üig, 39
unco - adj. hoch
unco - adj. hoch
uni kammal - n. Wolldecke
unmulan - n. ZerstoÃàrung, VerwuÃàstung
unnais - num. neunzehn, 19
unnat - adj. verbessert, hoch, gro√ü 
unnati - n. Fortschritt, Entwicklung, Verbesserung 
unnatishil - adj. fortschrittlich
unnayak - n. Exponent, Verbesserer
unnayan - n. Fortschritt, Verbesserung, Entwicklung
unpacas - num. neunundvierzig, 49 
unnu - v.t. umwinden, einfaÃàdeln, schnuÃàren, den Faden durch eine Nadel ziehen 
unsathi - num. neunundfuÃànfzig, 59
unt - n. Kamel
untis - num. neunundzwanzig, 29
upabhog - n. Genu√ü, VergnuÃàgen, Freude 
upabhokta - n. Verbraucher,Konsument
upacar - n. Mittel, Heilmittel
upadesh - n. Rat, Unterweisung, Instruktion
upadhi - n. Titel, Bezeichnung, Attribut
upahar - n. Geschenk
upaj - n. Produkt, Ertrag, Ernte
upakhyan - n. ErzaÃàhlung, Legende, alte Geschichte
upakram - n. Plan, Programm, Vorbereitungen, Anfang, Beginn, Vorwort, PraÃàambel
upalabdha - adj. erlangt, gewonnen, erreicht, erzielt
upalabdhi - n. Leistung, Errungenschaft 
upalakshya - n. Objekt, Ziel, Anliegen
upama - n. Vergleich, Gleichnis
upanisad - n. Upanishaden (der theologische Teil der Veden)
upanisadvadi - n. (jemand, der den Lehren der Upanishaden folgt)
upansanhar - n. Ende,Abschlu√ü 
upanyas - n. Roman
upar - postp. uÃàber
uparastrapati - n. VizepraÃàsident [eines Staates]
uparna- n. Schal, Halstuch, Schultertuch
upasabhapati - n. stellvertretender Vorsitzender [einer Versammlung, Organisation oder Partei]
upasthiti - n. Gegenwart
upataya - n. Tal
upa-usnakatibandhi - adj. subtropisch
upayog - n. Gebrauch, Nutzen, Anwendung
upayogita - n. NuÃàtzlichkeit, Nutzen
upayukta - adj. passend, geeignet
upeksha - n. KraÃànkung, Schmach, DemuÃàtigung, Mi√üachtung, Verachtung, GeringschaÃàtzung
upekshit - adj. ignoriert, mi√üachtet 
uphranu - v.i. springen
upiyan - n. Floh
uralnu - v.t. anzuÃànden, anfachen, entfachen
urlanu - v.i. aufwogen, in Wellen kommen; veraÃàrgert sein
usa - n. Morgengrauen, Tagesanbruch
usinnu - v.t. aufkochen
uso - adj. so wie das, solches 
uta - adv. dort, dorthin
utarnu - v.t. herunterkommen lassen, hinabsteigen lassen, ausziehen (Kleidung)
uthal-puthal - n. VeraÃànderung, Wandel, Wechsel
uthaunu - v.t. aufwecken
uthnu - v.i. aufstehen, sich erheben, stehen
uti - adv. so viel [wie]
utnikher - adv. inzwischen, gleichzeitig 
utpadan - n. Produktion, Herstellung
utpatti - n. Ursprung, Produktion, Herstellung
utpidak - n. UnterdruÃàcker
utpidit - n. UnterdruÃàckung, Verfolgung, BelaÃàstigung
utpidit varga - n. unterdruÃàckte Klasse
utranu - v.i. aussteigen, absteigen, sich erheben aus
utrinu - v.i. herunterkommen, hinabsteigen
utsaha - n. Enthusiasmus, Aufregung
utsav - n. Unterhaltung, Gala, Festlichkeit
utsukta - n. Enthusiasmus, Aufregung 
uttam - adj. hoÃàchster, oberster, bester 
uttano - adj. flach auf dem RuÃàcken
uttar - n. Antwort; Norden
uttaradhikari - n. Nachfolger, Erbe
uttaryayi - adj. verantwortlich
uttejit - adj. bewegt, erregt, aufgeregt
utthan - n. Erhebung, Aufstieg, Anhebung; Fortschritt, Emanzipation 
vacan - n. Rede
vad - n. Theorie, Diskussion, Kontroverse
vaicarik - adj. ideologisch
vaidhank - adj. verfassungsgemaÃà√ü, konstitutionell
vaisakh - n. erster Monat des nepalischen Kalenders [April-Mai]
vajracarya - n. Vajracharya,Bajracharya [ein Familienname newarischer Brahmanen] 
vaktavya - n. Rede, Stellungnahme
vampanti - n./adj. links [politisch], Linker 
van biralo - n. Wildkatze
van upabhokta samuha - n. Waldnutzergruppe
vanbhoja - n. Picknick
vanijya - n. Handel
vanko dhan - n. Waldressourcen
vansha - n. Klan, Dynastie, Lineage, Familie, Stamm, Generation, Stammbaum
vardan - n. Segen
varga - n. Klasse, Art
varga mil - n. Quadratmeile
varghahin - adj. klassenlos
vargahin samaj - n. klassenlose Gesellschaft 
varipari - adv. rundum, auf allen Seiten 
varnan - n. Beschreibung, ErzaÃàhlung, Bericht, Lobrede, Laudatio 
varsa - n. Jahr
varsa - n. Regenzeit, Monsun
varta - n. Verhandlung, Unterhandlung, GespraÃàch
vartalap - n. GespraÃàch, Unterhaltung, Dialog
vartaman - adj. gegenwaÃàrtig, bestehend, modern
vasanta - n. FruÃàhling, FruÃàhjahr
vasi - n. Bewohner
vastavik - adj. wirklich, tatsaÃàchlich 
vastavikta - n. Wirklichkeit, Wahrheit 
vastu - n. Gegenstand, Artikel, Substanz
vastutah - adv. de facto, wirklich, tatsaÃàchlich
vatavaran - n. Bedingung, Umstand, Situation, Umwelt
veda - n. Veda
vela - n. Zeit
veshya - n. Hure,Prostitutierte
vibhag - n. Abteilung, Department, Sektion
vibhagiya - adj. die Abteilung betreffend
vibhajan - n. Abteilung, Department, Sektion, Auteilung, Einteilung
vibhinna - adj. verschieden, divers
vicalan - n. Abweichung, Verlassen, Unstetigkeit
vicar - n. Betrachtung, Vorstellung, Idee
videsh - n. Ausland
videshi - n. AuslaÃànder
videshi sahayata - n. auswaÃàrtige Hilfe
vidhan - n. Satzung
vidheyak - n. Gesetz, Gesetzesvorlage 
vidhi - n. Art, Weise, Methode, Proze√ü
vidhipurvak - adv. gemaÃà√ü der Sitte, gemaÃà√ü dem Brauch
vidhipurvak - adv. gemaÃà√ü der Sitte, gemaÃà√ü dem Brauch
vidit - adj. bekannt
vidroha - n. Revolution, Aufstand, Rebellion, Revolte
vidvan - n./adj. Gelehrter, Wissenschaftler 
vidya - n. Wissenschaft, Lernen
vidyabhyas - n. Studium, Lernen
vidalaya - n. Schule, Seminar, College, Akademie
vidyarambha - n. das Erlernen
vidyarthi - n. Student, SchuÃàler
vidyarthi gatividhi - n. Studentenbewegung
vidyarthi - n. Schule, College, Akademie, Seminar 
vidyut - n. ElektrizitaÃàt
vigat - adj. vergangen, vorbei, voruÃàber
vighatan - n. Aufbrechen, AufloÃàsung, ZerstoÃàrung
vigyan - n. Wissenschaft, umfassende Kenntnis
vihin - postp. ohne
vhinata - n. das Nichtvorhandensein, Fehlen
vijay - n. Sieg, Triumph
vijaya - n. (ein Beiname der GoÃàttin Durga)
vijaya dashami - n. das Durga Purja-Fest, der zehnte Tag des dashain-Festes
vijayi - n./adj. siegreich, triumphierend
vijeta - n. Eroberer, Sieger, Gewinner
vikas - n. Entwicklung, Ausweitung, Ausdehnung, Evolution
vikasit - adj. entwickelt, entfaltet, ausgedehnt
vikasit - adj. entfaltet, gesprossen, entwickelt
vikat - adj. schwierig, entlegen
vikendrikaran - n. Dezentralisierung
vikhandan - n. Teilung, Aufsplitterung, Fragmentierung
vikhandit - adj. geteilt, getrennt, gespalten
vikriti - n. VeraÃànderung, Variation
vilas - n. FroÃàhlichkeit, Ausgelassenheit
vilayat - n. Ausland, Europa, England 
viman - n. Flugzeug, Luftschiff
vimansthal - n. Flugfeld, Flugpiste, Flughafen 
vinash - n. ZerstoÃàrung
vipanna - adj. bekuÃàmmert, erschuÃàttert, betroffen, in einem kritischen Zustand
viparit - adj. oppositionell, entgegengesetzt, feindlich
viphal - adj. nutzlos, erfolglos, furchtlos
vir - adj. tapfer, mutig, verwegen, kuÃàhn, maÃàchtig
virahah - n. Trennung
virodh - n. Feindseligkeit, Feindschaft, Meinungsverschiedenheit, Antagonismus
viruddha - postp. gegen, entgegen, oppositionell
visakta - adj. vergiftet
visalu - adj. vergiftet
visaya . n. Gegenstand, Artikel, Thema
visaya-kram - n. Inhaltsverzeichnis
visayantar - n. ein anderes Thema
vasayapravesh - n. Einleitung,Vorwort
visaya-pravesh -n. EinfuÃàhrung, Vorwort
visayavastu - n. Diskussionsgegenstand, Diskussionsthema
vishal - adj. gro√ü, sehr gro√ü, gigantisch, riesig
vishes - adv. besonders, beruÃàhmt, bekannt
vishes adalat - n. Sondergerichtshof n. Eigenname
vishesagya - n. Experte, Spezialist n. Adjektiv
vishesya - n. Substantiv, Subjekt
vishista - adj. au√üergewoÃàhnlich, ungewoÃàhnlich, beruÃàhmt, besonders
vishva - n. Welt, Universum
vishvas - n. Glaube, Vertrauen
vishvasniya - adj. vertrauenswuÃàrdig
vishvaniyata - n. VertrauenswuÃàrdigkeit 
vishvaspatra - n. Vertrauter
vishvavidyalaya - n. UniversitaÃàt
vishvayuddha - n. Weltkrieg
viskambhak - n. Zwischenspiel, Balken, Bolzen
vismayadibodhak - n. Interjektion
visphot - n. Ausbruch, Eruption, Bersten
visphotak - adj. explosiv
vistar - n. Ausdehnung, Erstreckung 
vistarit - adj. erweitert, vergroÃà√üert
vivad - n. Diskussion, Debatte, Meinungsverschiedenheit, Disput
vivaha - n. Hochzeit, Heirat
vivaran - n. Beschreibung 
vivash - adj. abhaÃàngig, hilflos
vividh - adj. unterschiedlich, verschieden
vividhta - n. Unterschiedlichkeit, Verschiedenartigkeit, Variation 
vriddha - adj. alt, grau
vriddhavastha - n. Alter, die alten Tage 
vriddhi - n. Fortschritt
vrihaspativar - n. Donnerstag
vriksha - n. Baum
vriksharopan - n. Baumpflanzung, Anpflanzung von BaÃàumen
vrisadeva - n. Vrishadeva [Name eines Licchavi-KoÃànigs; Urgro√üvater von Manadeva I.]
vyakhya - n. ErklaÃàrung, ErlaÃàuterung
vyakhan - n. Rede, Ansprache, Vortrag 
vyakta - adj. ausgedruÃàckt, zum Ausdruck gebracht, klar, bestimmt 
vyakti - n. Person, Individuum
vyaktigat - adj. persoÃànlich, privat
vyaktitva - yn. PersoÃànlichkeit, IndividualitaÃàt n. Eigenname
vyangya - n. Sarkasmus, Ironie
vyangya-citra - n. Cartoon
vyapar - n. GeschaÃàft, Handel
vyapta - adj. verbreitet, erfuÃàllt, besetzt, verstreut, bedeckt 
vyatha - n. Leid, Schmerz
vyavahar - n. Verhalten, Brauch, Behandlung
vyavasay - n. BeschaÃàftigung, TaÃàtigkeit, Beruf
vyavastha - n. Methode, Regulierung, Systematisierung, Management, Gesetzgebung, Legislation, System, Festlegung
vyavasthapan - n. Organisierung, Systematisierung
vyavasthapika - n. Legislative
vyavasthapit - adj. systematisiert, etabliert 
vyavasthit - adj. systematisiert, etabliert 
yadyapi - conj. obgleich, obschon
yagya - n. religioÃàses Opfer
yahan - adv. hier, hierhin
yahi - pron. [gerade] dies
yahi nai - pron. dies und kein anderes
yas karan - aus diesem Grund, daher in diesem Zusammenhang 
yasaigari - adv. also, daher, folglich
yashasvi - adj. bekannt, anerkannt, beruÃàhmt
yashogan - n. Lobrede, Lobpreisung, Preislied
yahan - adv. hierunter, hierin
yaso - adj. so wie dies, solches 
yasogari - adv. also, daher, folglich 
yasto - pron. ein solcher
yasto andhyaroma - comp. bei einer solchen Dunkelheit 
yata - adv. hier, hierhin
yata - adv. hin und her, uÃàberall herum
yatayat - n. Verkehr, Transport, Kommen und Gehen
yathavat - adv. wie gehabt, wie zuvor 
yati - adv. so viel
yatiko - adv. so viel, so wenig
yatra - n. Reise
yatri - n. Reisender, Passagier 
yatro - pron. dieser gro√üe, dieser lange 
yauvan - n. Jugend, Jugendlichkeit
yayavar - n. Nomade, Vagabund
yog - n. Addition
yogdan - n. Zusammenarbeit, Kooperation, Hilfe, Beistand, UnterstuÃàtzung, Beitrag
yogaphal - n. Gesamtsumme
yogyata - n. StaÃàrke, Macht, Talent 
yojana - n. Planung, Plan, Projekt 
yug - n. Zeitalter, Epoche, AÃàra 
yugoslabhiya - n. Jugoslawien
yurop - n. Europa adj. europaÃàisch 
yuva - n. Jugend
yuvati - n. junge Frau, jugendliche Frau

